,date,measurements,ok,anomalies,ratio
0,2021-01-01,611131,609664,1467,0.0024004673302450703
1,2021-01-04,9354,9329,25,0.0026726534103057517
2,2021-01-05,606155,605118,1037,0.001710783545462794
3,2021-01-07,12221,12190,31,0.002536617298093446
4,2021-01-08,586988,585711,1277,0.002175512957675455
5,2021-01-11,12782,12732,50,0.003911750899702707
6,2021-01-12,994,994,0,0.0
7,2021-01-14,9047,9032,15,0.001658008179507019
8,2021-01-15,566484,565494,990,0.0017476221746774842
9,2021-01-18,11018,10998,20,0.0018152114721365039
10,2021-01-19,574301,573053,1248,0.002173076487765127
11,2021-01-21,17522,17477,45,0.0025681999771715557
12,2021-01-22,532429,531278,1151,0.002161790586162662
13,2021-01-25,17019,16969,50,0.0029378929431811505
14,2021-01-26,148284,147912,372,0.002508699522537833
15,2021-01-27,400956,399480,1476,0.0036812019273935294
16,2021-01-28,16955,16905,50,0.002948982601002654
17,2021-01-29,155259,154946,313,0.0020159861908166355
18,2021-01-30,395277,394414,863,0.0021832790675905757
19,2021-02-01,11956,11831,125,0.010455001672800267
20,2021-02-02,535137,533920,1217,0.0022741839940052734
21,2021-02-04,3469,3451,18,0.0051888152205246466
22,2021-02-05,592360,590857,1503,0.0025373083935444664
23,2021-02-08,4630,4600,30,0.0064794816414686825
24,2021-02-09,580988,579934,1054,0.0018141510668034451
25,2021-02-11,4713,4686,27,0.005728835136855506
26,2021-02-12,561641,560413,1228,0.002186450063296661
27,2021-02-15,16300,16247,53,0.0032515337423312885
28,2021-02-16,551497,550131,1366,0.002476894706589519
29,2021-02-18,21503,21478,25,0.0011626284704459842
30,2021-02-19,555240,554041,1199,0.0021594265542828326
31,2021-02-22,8428,8425,3,0.0003559563360227812
32,2021-02-23,545409,544109,1300,0.0023835323582852503
33,2021-02-25,30927,30883,44,0.0014227050797038187
34,2021-02-26,513485,512546,939,0.0018286804872586345
35,2021-03-01,6156,6141,15,0.0024366471734892786
36,2021-03-02,567336,566020,1316,0.0023196130687987366
37,2021-03-18,4450,4450,0,0.0
38,2021-03-19,583052,581754,1298,0.0022262165295719766
39,2021-03-22,11160,11159,1,8.960573476702509e-05
40,2021-03-23,560864,559906,958,0.0017080789638842927
41,2021-03-25,14754,14753,1,6.777822963264199e-05
42,2021-03-26,540479,539479,1000,0.001850210646482102
43,2021-03-29,11220,11220,0,0.0
44,2021-03-30,570583,569813,770,0.0013494969180645059
45,2021-04-02,537193,536443,750,0.001396146264005674
46,2021-04-05,11199,11199,0,0.0
47,2021-04-06,568930,568110,820,0.0014413020934034063
48,2021-04-08,11843,11842,1,8.443806467955755e-05
49,2021-04-09,545836,544822,1014,0.0018577008478737203
50,2021-04-12,19721,19706,15,0.0007606105167080777
51,2021-04-13,562859,561592,1267,0.0022510078012432954
52,2021-04-15,20876,20863,13,0.0006227246598965319
53,2021-04-16,567739,566730,1009,0.0017772250981524962
54,2021-04-19,33293,33278,15,0.0004505451596431682
55,2021-04-20,541845,540961,884,0.0016314628722236065
56,2021-04-22,26884,26867,17,0.0006323463770272281
57,2021-04-23,550775,547749,3026,0.005494076528527983
58,2021-04-26,656550,655867,683,0.0010402863452897723
59,2021-04-29,663650,662927,723,0.0010894296692533715
60,2021-04-30,70,70,0,0.0
61,2021-05-03,553826,553349,477,0.0008612813410710223
62,2021-05-06,649036,648382,654,0.001007648266043794
63,2021-05-09,6376,6376,0,0.0
64,2021-05-10,586965,586471,494,0.0008416174729327984
65,2021-05-13,637194,636266,928,0.0014563853394727508
66,2021-05-17,664259,663578,681,0.0010252025188969966
67,2021-05-18,151,151,0,0.0
68,2021-05-20,671656,670948,708,0.0010541110330288123
69,2021-05-24,342985,342734,251,0.0007318104290275085
70,2021-05-25,302349,301952,397,0.00131305213511538
71,2021-05-27,354615,354400,215,0.0006062913300339805
72,2021-05-28,304308,304018,290,0.0009529818473388804
73,2021-06-04,297207,296499,708,0.0023821780779052985
74,2021-06-07,357436,357134,302,0.0008449065007441891
75,2021-06-08,312179,311570,609,0.0019508038657308788
76,2021-06-10,354513,354239,274,0.0007728912620975818
77,2021-06-11,282790,282096,694,0.0024541178966724425
78,2021-06-14,339298,339126,172,0.0005069290122547141
79,2021-06-15,261176,260278,898,0.0034382944834134834
80,2021-06-17,321133,321002,131,0.00040793067046986765
81,2021-06-18,262542,261888,654,0.002491030006627511
82,2021-06-21,284115,283852,263,0.0009256815022086127
83,2021-06-22,281063,280460,603,0.0021454264702219787
84,2021-06-24,338752,338440,312,0.0009210277725297562
85,2021-06-25,270449,270266,183,0.0006766525296821212
86,2021-06-28,349920,349594,326,0.0009316415180612712
87,2021-06-29,299430,298636,794,0.002651704905988044
88,2021-07-01,332145,331550,595,0.0017913862921314487
89,2021-07-02,304145,303570,575,0.0018905456279077414
90,2021-07-05,339455,338888,567,0.0016703244907277843
91,2021-07-06,304356,303847,509,0.0016723836559818107
92,2021-07-07,27312,27289,23,0.0008421206795547745
93,2021-07-08,277676,277432,244,0.0008787219637275097
94,2021-07-09,286955,286391,564,0.0019654649683748322
95,2021-07-12,302966,302364,602,0.00198702164599328
96,2021-07-13,300534,299871,663,0.002206073189722294
97,2021-07-15,340852,340273,579,0.0016986844730264162
98,2021-07-16,284223,283748,475,0.0016712229481780153
99,2021-07-19,319769,319542,227,0.0007098874500029708
100,2021-07-22,322080,321882,198,0.0006147540983606558
101,2021-07-23,308004,307059,945,0.0030681419721821793
102,2021-07-26,285608,285380,228,0.0007982969664715274
103,2021-07-27,287272,286553,719,0.002502854437606171
104,2021-07-29,327532,326386,1146,0.0034988947644810277
105,2021-07-30,253871,253214,657,0.0025879285148756653
106,2021-08-02,304834,304612,222,0.0007282652197589508
107,2021-08-03,284574,283531,1043,0.0036651275239480766
108,2021-08-05,321579,321119,460,0.0014304416644121663
109,2021-08-06,296936,295937,999,0.0033643613438586093
110,2021-08-09,307150,307056,94,0.0003060393944326876
111,2021-08-10,226432,225937,495,0.0021860867721876765
112,2021-08-12,293576,293164,412,0.0014033844728451917
113,2021-08-13,279420,278586,834,0.002984754133562379
114,2021-08-16,282470,282075,395,0.0013983785888766948
115,2021-08-20,516981,516389,592,0.0011451097815973895
116,2021-08-21,46637,46613,24,0.0005146128610330853
117,2021-08-23,294204,293911,293,0.0009959076015281913
118,2021-08-24,292893,291980,913,0.0031171793112160415
119,2021-08-26,298516,297937,579,0.0019395945275965107
120,2021-08-27,276430,275793,637,0.002304380855912889
121,2021-08-30,284083,283788,295,0.0010384289098608506
122,2021-08-31,250404,249985,419,0.001673295953738758
123,2021-09-03,277390,276417,973,0.0035076967446555393
124,2021-09-06,286184,286075,109,0.000380873843401448
125,2021-09-10,283051,282397,654,0.002310537676955743
126,2021-09-13,300626,300500,126,0.0004191254249466114
127,2021-09-14,274636,274073,563,0.002049986163503692
128,2021-09-16,308985,308802,183,0.0005922617602796252
129,2021-09-17,274531,273957,574,0.002090838557394247
130,2021-09-20,307394,307265,129,0.0004196568573231748
131,2021-09-21,282100,281566,534,0.0018929457639135058
132,2021-09-23,272025,271858,167,0.000613914162301259
133,2021-09-24,294308,293740,568,0.0019299509357543797
134,2021-09-27,290804,290712,92,0.0003163642865985337
135,2021-09-28,295452,294562,890,0.0030123336447206313
136,2021-09-30,274077,273882,195,0.0007114788909685964
137,2021-10-01,292363,291768,595,0.0020351412456432586
138,2021-10-04,290072,289918,154,0.0005309026724399459
139,2021-10-05,287612,286637,975,0.0033899837280781052
140,2021-10-07,298296,298154,142,0.0004760372247700271
141,2021-10-08,272203,271632,571,0.0020976991436538173
142,2021-10-11,308601,308491,110,0.0003564473219464616
143,2021-10-14,288288,288170,118,0.0004093129093129093
144,2021-10-15,286956,286298,658,0.002293034472183889
145,2021-10-18,282366,282249,117,0.000414355836042583
146,2021-10-19,278234,277621,613,0.0022031814947130832
147,2021-10-21,288978,288859,119,0.00041179605367882676
148,2021-10-22,252745,251847,898,0.003552988189677343
149,2021-10-25,294482,294346,136,0.00046182788761282525
150,2021-10-26,281868,281320,548,0.001944172449515376
151,2021-10-28,296499,296181,318,0.0010725162648103366
152,2021-10-29,266991,266198,793,0.0029701375701802683
153,2021-11-01,282843,282643,200,0.0007071060623738257
154,2021-11-02,272191,271641,550,0.0020206399182926696
155,2021-11-04,253808,253681,127,0.0005003782386685999
156,2021-11-05,270737,270034,703,0.0025966159039953903
157,2021-11-08,283692,283588,104,0.00036659475769496496
158,2021-11-11,263834,263764,70,0.00026531834411031176
159,2021-11-15,279919,279790,129,0.0004608476023421061
160,2021-11-18,288572,288403,169,0.0005856424046685056
161,2021-11-22,296695,296621,74,0.0002494143817725273
162,2021-11-25,296205,296132,73,0.0002464509376951773
163,2021-12-03,202254,202210,44,0.00021754823143176402
164,2021-12-04,83876,83848,28,0.0003338261242786971
165,2021-12-06,288145,288046,99,0.0003435770185149838
166,2021-12-07,269848,269308,540,0.002001126560137559
167,2021-12-09,301867,301682,185,0.0006128526801538426
168,2021-12-10,253537,253130,407,0.0016052883799997633
169,2021-12-13,294479,294241,238,0.0008082070368345451
170,2021-12-14,216745,216340,405,0.0018685552146531638
171,2021-12-15,14505,14493,12,0.000827300930713547
172,2021-12-16,357303,356907,396,0.001108303036918246
173,2021-12-17,192408,192073,335,0.0017410918464928692
174,2021-12-19,38028,37997,31,0.0008151888082465552
175,2021-12-20,320665,320293,372,0.001160089189652753
176,2021-12-21,197506,197200,306,0.0015493200206576003
177,2021-12-22,30549,30522,27,0.0008838259844839438
178,2021-12-23,335814,335504,310,0.0009231300660484673
179,2021-12-24,195707,195386,321,0.0016402070442038353
180,2021-12-26,23052,22976,76,0.00329689397883047
181,2021-12-27,253581,253082,499,0.001967813045930097
182,2021-12-28,196114,195744,370,0.0018866577602822847
183,2021-12-29,28867,28806,61,0.002113139571136592
184,2021-12-30,308726,308186,540,0.0017491238185316429
185,2021-12-31,204201,203890,311,0.001523009191923644
186,2022-01-03,381839,381441,398,0.0010423241208991224
187,2022-01-04,190581,190234,347,0.0018207481333396298
188,2022-01-05,42587,42557,30,0.0007044403221640406
189,2022-01-06,317870,317609,261,0.000821090382860918
190,2022-01-07,184303,183976,327,0.0017742521825472185
191,2022-01-10,296205,295945,260,0.0008777704630239193
192,2022-01-12,14401,14397,4,0.00027775848899381985
193,2022-01-13,274135,273938,197,0.0007186240356028963
194,2022-01-14,217871,217363,508,0.0023316549701428825
195,2022-01-16,40552,40425,127,0.003131781416452949
196,2022-01-17,300886,300372,514,0.001708288188882168
197,2022-01-18,180423,180000,423,0.002344490447448496
198,2022-01-19,31692,31636,56,0.0017670074466742396
199,2022-01-20,322591,322198,393,0.0012182608938253081
200,2022-01-21,180228,179971,257,0.001425971547151386
201,2022-01-23,34445,34326,119,0.0034547829873711714
202,2022-01-24,259591,259280,311,0.0011980384527968998
203,2022-01-25,181855,181633,222,0.0012207527975584944
204,2022-01-26,37903,37838,65,0.0017149038334696462
205,2022-01-27,352067,351659,408,0.0011588703286590336
206,2022-01-28,176057,175791,266,0.00151087431911256
207,2022-01-30,41840,41767,73,0.0017447418738049713
208,2022-01-31,294058,293813,245,0.0008331689666664399
209,2022-02-01,180771,180488,283,0.0015655165928163256
210,2022-02-02,39205,39113,92,0.0023466394592526465
211,2022-02-03,305772,305325,447,0.001461873552843295
212,2022-02-04,175967,175763,204,0.0011593082793932953
213,2022-02-06,35248,35152,96,0.0027235587834770767
214,2022-02-07,321276,320651,625,0.0019453678457152107
215,2022-02-08,183918,183620,298,0.001620287301949782
216,2022-02-09,19683,19665,18,0.0009144947416552355
217,2022-02-10,343367,342997,370,0.0010775642388464821
218,2022-02-11,190335,190069,266,0.0013975359235032967
219,2022-02-13,43155,43149,6,0.00013903371567605143
220,2022-02-14,316565,316461,104,0.00032852652693759576
221,2022-02-15,189759,189371,388,0.002044698802164851
222,2022-02-16,42921,42863,58,0.0013513198667319027
223,2022-02-17,311315,310944,371,0.0011917189984420925
224,2022-02-18,186532,186318,214,0.0011472562348551455
225,2022-02-19,25091,25031,60,0.002391295683711291
226,2022-02-20,31904,31876,28,0.0008776328986960883
227,2022-02-21,319883,319548,335,0.0010472579036710297
228,2022-02-22,187922,187649,273,0.00145273038813976
229,2022-02-23,18925,18920,5,0.0002642007926023778
230,2022-02-24,333969,333685,284,0.000850378328527498
231,2022-02-25,184133,183804,329,0.001786751967327964
232,2022-02-28,351925,351510,415,0.0011792285288058535
233,2022-03-01,206434,206085,349,0.0016906129804198922
234,2022-03-02,8965,8947,18,0.002007808142777468
235,2022-03-03,352083,351241,842,0.0023914815540653765
236,2022-03-04,198961,198648,313,0.001573172631822317
237,2022-03-06,3424,3416,8,0.002336448598130841
238,2022-03-07,356506,355967,539,0.0015118960129703288
239,2022-03-08,205187,204890,297,0.0014474601217426056
240,2022-03-09,8717,8711,6,0.0006883101984627739
241,2022-03-10,332265,331724,541,0.001628218440100522
242,2022-03-11,198524,198113,411,0.0020702786564848583
243,2022-03-14,305465,305335,130,0.00042558067209009213
244,2022-03-15,197821,197537,284,0.001435641312095278
245,2022-03-16,33130,33115,15,0.00045276184726833685
246,2022-03-17,281861,281661,200,0.0007095696105527192
247,2022-03-20,15723,15714,9,0.0005724098454493417
248,2022-03-21,315788,315463,325,0.0010291714694668575
249,2022-03-22,188810,188306,504,0.0026693501403527355
250,2022-03-23,15943,15926,17,0.001066298689079847
251,2022-03-24,313908,313425,483,0.0015386673802515387
252,2022-03-25,189553,189087,466,0.0024584153244738938
253,2022-03-28,10969,10954,15,0.0013674901996535691
254,2022-03-29,192890,192621,269,0.0013945772201773032
255,2022-03-30,18760,18743,17,0.0009061833688699361
256,2022-03-31,312348,311978,370,0.0011845761778529077
257,2022-04-01,196883,196398,485,0.0024633919637551236
258,2022-04-03,19444,19425,19,0.0009771651923472537
259,2022-04-04,326685,326343,342,0.0010468800220395794
260,2022-04-05,196070,195764,306,0.0015606671086856735
261,2022-04-06,10134,10113,21,0.0020722320899940793
262,2022-04-07,295262,294746,516,0.0017476004362227445
263,2022-04-08,197706,197064,642,0.0032472459105945192
264,2022-04-10,19313,19282,31,0.0016051364365971107
265,2022-04-11,335693,335079,614,0.0018290521399016363
266,2022-04-12,187908,187503,405,0.002155310045341337
267,2022-04-13,11028,10994,34,0.0030830612985128765
268,2022-04-14,350689,349553,1136,0.0032393374186244794
269,2022-04-15,170010,169795,215,0.001264631492265161
270,2022-04-17,36461,36391,70,0.0019198595759852993
271,2022-04-18,284894,284254,640,0.00224644955667722
272,2022-04-19,173863,172910,953,0.0054813272519167395
273,2022-04-20,29297,29199,98,0.003345052394443117
274,2022-04-21,330141,329421,720,0.0021808863485601607
275,2022-04-22,173217,172961,256,0.0014779149852497157
276,2022-04-24,4355,4348,7,0.0016073478760045925
277,2022-04-25,70375,70312,63,0.0008952042628774423
278,2022-04-26,96528,96506,22,0.00022791314437261727
279,2022-04-27,49923,49832,91,0.0018228071229693728
280,2022-04-28,279881,279447,434,0.0015506590300877873
281,2022-04-29,165669,164915,754,0.004551243745057916
282,2022-04-30,34076,34034,42,0.0012325390304026294
283,2022-05-02,347608,346667,941,0.00270707233435364
284,2022-05-03,179326,178402,924,0.005152627059099071
285,2022-05-04,23437,23394,43,0.0018347058070572171
286,2022-05-05,321447,320790,657,0.0020438828173851365
287,2022-05-06,172078,171790,288,0.0016736596194748892
288,2022-05-09,133264,133091,173,0.0012981750510265338
289,2022-05-10,117126,116638,488,0.004166453221317214
290,2022-05-12,131099,130957,142,0.0010831509012273167
291,2022-05-13,102991,102540,451,0.004379023409812508
292,2022-05-16,124024,123853,171,0.0013787654002451139
293,2022-05-17,117745,117274,471,0.004000169858592722
294,2022-05-19,130274,129985,289,0.002218401215898798
295,2022-05-20,116283,115821,462,0.00397306571037899
296,2022-05-23,24036,24036,0,0.0
297,2022-05-24,111584,111091,493,0.0044181961571551475
298,2022-05-26,128286,127983,303,0.0023619101071044387
299,2022-05-27,96513,96048,465,0.004818003792235243
300,2022-05-30,140210,139494,716,0.005106625775622281
301,2022-05-31,110165,109937,228,0.002069622838469568
302,2022-06-02,138207,137481,726,0.005252990080097246
303,2022-06-03,102153,101940,213,0.002085107632668644
304,2022-06-06,132198,131756,442,0.0033434696440188204
305,2022-06-07,91054,90883,171,0.001878006457706416
306,2022-06-09,136204,135474,730,0.0053596076473525
307,2022-06-10,100150,99928,222,0.002216674987518722
308,2022-06-13,136745,135985,760,0.005557790047168086
309,2022-06-14,98147,97934,213,0.0021702140666551195
310,2022-06-16,138207,137478,729,0.005274696650676159
311,2022-06-17,100883,100659,224,0.0022203939216716394
312,2022-06-20,135257,134631,626,0.004628226265553724
313,2022-06-21,98689,98483,206,0.0020873653598678676
314,2022-06-23,138138,137434,704,0.005096352922439879
315,2022-06-24,96096,95938,158,0.0016441891441891442
316,2022-06-27,137156,136399,757,0.005519262737321007
317,2022-06-28,98673,98414,259,0.0026248315141933457
318,2022-06-30,134698,133900,798,0.005924364133097744
319,2022-07-01,70595,70412,183,0.0025922515758906436
320,2022-07-04,132015,131370,645,0.00488580843086013
321,2022-07-05,96232,95989,243,0.0025251475600631804
322,2022-07-07,154231,153435,796,0.0051610895345293745
323,2022-07-08,73916,73786,130,0.0017587531792845933
324,2022-07-12,100950,100728,222,0.002199108469539376
325,2022-07-14,139311,138560,751,0.0053908162313098034
326,2022-07-15,90855,90652,203,0.002234329426008475
327,2022-07-18,156784,155972,812,0.005179099908153894
328,2022-07-19,80487,80315,172,0.002136991066880366
329,2022-07-21,158129,157310,819,0.00517931562205541
330,2022-07-22,82132,81961,171,0.00208201431841426
331,2022-07-25,151995,151384,611,0.004019869074640613
332,2022-07-26,64038,64030,8,0.00012492582529123334
333,2022-07-28,149019,148384,635,0.004261201591743335
334,2022-07-29,75090,74922,168,0.002237315221733919
335,2022-08-01,156519,155882,637,0.004069793443607485
336,2022-08-02,79704,79545,159,0.0019948810599217104
337,2022-08-04,150000,149355,645,0.0043
338,2022-08-05,81271,80812,459,0.005647771037639502
339,2022-08-08,149619,148831,788,0.0052667107787112595
340,2022-08-09,77202,77038,164,0.002124297297997461
341,2022-08-11,154209,153253,956,0.006199378765182318
342,2022-08-12,81152,80966,186,0.0022919952681388013
343,2022-08-15,151779,150980,799,0.005264232864889082
344,2022-08-16,78129,77938,191,0.0024446748326485686
345,2022-08-18,155324,154359,965,0.006212819654399835
346,2022-08-19,70916,70748,168,0.0023689999435952394
347,2022-08-22,147819,146907,912,0.006169707547744201
348,2022-08-23,85122,84889,233,0.0027372477150442893
349,2022-08-25,135949,135066,883,0.006495082714841595
350,2022-08-26,96960,96726,234,0.0024133663366336633
351,2022-08-29,158576,157633,943,0.005946675411159318
352,2022-08-30,79784,79616,168,0.0021056853504462045
353,2022-09-01,156377,155388,989,0.006324459479335197
354,2022-09-02,78107,77923,184,0.0023557427631326257
355,2022-09-05,154696,153771,925,0.0059794694109737805
356,2022-09-06,79856,79681,175,0.002191444600280505
357,2022-09-08,133581,132764,817,0.006116139271303554
358,2022-09-09,95821,95580,241,0.00251510629194018
359,2022-09-12,152005,151055,950,0.006249794414657413
360,2022-09-13,80525,80337,188,0.002334678671220118
361,2022-09-15,143947,142935,1012,0.00703036534279978
362,2022-09-16,81868,81681,187,0.002284164753017052
363,2022-09-19,135273,134335,938,0.006934125804853888
364,2022-09-20,86384,86148,236,0.002731987405075014
365,2022-09-22,144023,143099,924,0.006415641946078057
366,2022-09-23,90065,89844,221,0.00245378337867096
367,2022-09-26,15763,15707,56,0.003552623231618347
368,2022-09-27,214440,213344,1096,0.005110986756202201
369,2022-09-29,145308,144552,756,0.005202741762325543
370,2022-09-30,82839,82647,192,0.0023177488863940898
371,2022-10-03,142063,141081,982,0.006912426177118602
372,2022-10-04,83908,83751,157,0.0018710969156695428
373,2022-10-06,139159,138199,960,0.006898583634547532
374,2022-10-07,82407,82209,198,0.002402708507772398
375,2022-10-10,140552,139623,929,0.0066096533667254825
376,2022-10-11,86411,86224,187,0.0021640763328742867
377,2022-10-13,153198,152818,380,0.0024804501364247577
378,2022-10-14,84926,84762,164,0.001931092951510727
379,2022-10-19,15168,15081,87,0.005735759493670886
380,2022-10-20,141097,140486,611,0.004330354295272047
381,2022-10-21,83764,83586,178,0.002125017907454276
382,2022-10-23,18302,18215,87,0.004753578843842203
383,2022-10-24,137485,136891,594,0.004320471324144452
384,2022-10-25,82455,82134,321,0.0038930325632163
385,2022-10-27,161434,160793,641,0.003970662933458875
386,2022-10-28,74789,74648,141,0.0018853039885544666
387,2022-10-30,19466,19396,70,0.0035960135621082912
388,2022-10-31,138892,138347,545,0.003923912104368862
389,2022-11-01,81903,81746,157,0.0019169017007924008
390,2022-11-03,165823,165179,644,0.0038836590822744735
391,2022-11-04,64426,64283,143,0.0022196007822928633
392,2022-11-06,26842,26725,117,0.0043588406229044035
393,2022-11-07,135236,134733,503,0.003719423822059215
394,2022-11-08,72358,72169,189,0.0026120124934354183
395,2022-11-09,15135,15067,68,0.004492897258011232
396,2022-11-10,137863,137317,546,0.003960453493685761
397,2022-11-11,70942,70928,14,0.0001973443094358772
398,2022-11-13,19728,19656,72,0.0036496350364963502
399,2022-11-14,145992,145405,587,0.004020768261274591
400,2022-11-15,64304,64159,145,0.0022549141577506843
401,2022-11-16,14031,13974,57,0.004062433183664742
402,2022-11-17,140261,139637,624,0.004448848931634596
403,2022-11-18,83281,83103,178,0.0021373422509335864
404,2022-11-20,18322,18256,66,0.0036022268311319723
405,2022-11-21,140479,140097,382,0.0027192676485453342
406,2022-11-22,76386,76237,149,0.0019506192234179038
407,2022-11-23,11561,11499,62,0.005362857884266067
408,2022-11-24,139677,138821,856,0.006128424865940706
409,2022-11-25,85973,85803,170,0.0019773649866818652
410,2022-11-27,5499,5463,36,0.006546644844517185
411,2022-11-28,138233,137492,741,0.0053605144936447885
412,2022-11-29,84867,84695,172,0.002026700602118609
413,2022-11-30,3612,3606,6,0.0016611295681063123
414,2022-12-01,144300,143979,321,0.0022245322245322244
415,2022-12-02,87331,87164,167,0.0019122648315031319
416,2022-12-04,7101,7082,19,0.002675679481763132
417,2022-12-05,146631,146310,321,0.0021891687296683514
418,2022-12-06,77423,77226,197,0.002544463531508725
419,2022-12-07,8271,8229,42,0.005077983315197679
420,2022-12-08,145039,144429,610,0.00420576534587249
421,2022-12-09,81887,81717,170,0.0020760316045281913
422,2022-12-11,8262,8218,44,0.00532558702493343
423,2022-12-12,147104,146504,600,0.00407874700891886
424,2022-12-13,82273,82110,163,0.0019812089020699378
425,2022-12-14,8295,8230,65,0.007836045810729355
426,2022-12-15,147394,146799,595,0.004036799326973961
427,2022-12-16,78643,78479,164,0.002085373141919815
428,2022-12-19,149640,148759,881,0.005887463245121625
429,2022-12-20,83735,83568,167,0.0019943870543978025
430,2022-12-21,7970,7922,48,0.00602258469259724
431,2022-12-22,141586,141036,550,0.00388456485810744
432,2022-12-23,82505,82333,172,0.002084722138052239
433,2022-12-25,7436,7392,44,0.005917159763313609
434,2022-12-26,139533,138970,563,0.0040348878043186915
435,2022-12-27,80312,80142,170,0.0021167446956868213
436,2022-12-29,141610,140843,767,0.005416284160723113
437,2022-12-30,89012,88829,183,0.0020559025749337166
438,2023-01-01,14818,14774,44,0.0029693615872587393
439,2023-01-02,140187,139880,307,0.0021899320193741216
440,2023-01-03,73594,73589,5,6.794032122183874e-05
441,2023-01-04,13653,13610,43,0.003149490954369003
442,2023-01-05,140617,140245,372,0.0026454838319691074
443,2023-01-06,73497,73009,488,0.006639726791569724
444,2023-01-08,11351,11316,35,0.0030834287727953486
445,2023-01-09,120732,120534,198,0.0016399960242520625
446,2023-01-10,89300,89209,91,0.001019036954087346
447,2023-01-11,4706,4689,17,0.003612409689757756
448,2023-01-12,128899,128605,294,0.0022808555535729523
449,2023-01-13,90311,90213,98,0.0010851391303384969
450,2023-01-16,129542,129354,188,0.0014512667706226552
451,2023-01-17,89490,89434,56,0.0006257682422617052
452,2023-01-18,4509,4500,9,0.001996007984031936
453,2023-01-19,125140,124962,178,0.0014224069042672208
454,2023-01-20,89962,89902,60,0.0006669482670460861
455,2023-01-22,3736,3726,10,0.0026766595289079227
456,2023-01-23,130322,129967,355,0.00272402203772195
457,2023-01-24,92567,92562,5,5.401492972657643e-05
458,2023-01-25,3798,3790,8,0.00210637177461822
459,2023-01-26,131878,131537,341,0.0025857231683828995
460,2023-01-27,82808,82791,17,0.00020529417447589604
461,2023-01-30,120200,119827,373,0.003103161397670549
462,2023-01-31,104772,103966,806,0.007692895048295346
463,2023-02-01,5846,5825,21,0.0035921997947314403
464,2023-02-02,107556,107256,300,0.0027892446725426754
465,2023-02-03,96257,95448,809,0.008404583562753878
466,2023-02-05,2850,2838,12,0.004210526315789474
467,2023-02-06,129439,128719,720,0.005562465717442193
468,2023-02-07,75630,75620,10,0.0001322226629644321
469,2023-02-08,4985,4940,45,0.009027081243731194
470,2023-02-09,130961,130231,730,0.0055741785722467
471,2023-02-10,76259,76251,8,0.00010490565048059902
472,2023-02-13,118751,118367,384,0.003233656979730697
473,2023-02-14,100282,99758,524,0.0052252647533954245
474,2023-02-15,9551,9518,33,0.0034551355878965555
475,2023-02-16,107152,106781,371,0.0034623712109899956
476,2023-02-17,93454,92872,582,0.006227662807370471
477,2023-02-20,116885,116490,395,0.0033793899987166875
478,2023-02-21,97343,96815,528,0.005424118837512713
479,2023-02-22,5057,5034,23,0.004548151077714059
480,2023-02-23,110396,110065,331,0.002998297039747817
481,2023-02-24,92632,92113,519,0.005602815441747992
482,2023-02-26,6752,6721,31,0.004591232227488151
483,2023-02-27,106634,106286,348,0.0032634994467055536
484,2023-02-28,102939,102355,584,0.005673262806127901
485,2023-03-01,6923,6893,30,0.0043333814820164665
486,2023-03-02,106365,106057,308,0.0028956893715037842
487,2023-03-03,91649,91133,516,0.005630175997555892
488,2023-03-04,11580,11511,69,0.005958549222797927
489,2023-03-05,6039,6012,27,0.004470938897168405
490,2023-03-06,107249,106773,476,0.004438269820697629
491,2023-03-07,105060,104487,573,0.005454026270702456
492,2023-03-09,117734,117200,534,0.004535648156012707
493,2023-03-10,98554,98026,528,0.00535746900176553
494,2023-03-13,114775,114419,356,0.003101720758004792
495,2023-03-14,95370,94838,532,0.005578274090384817
496,2023-03-15,5713,5686,27,0.004726063364256958
497,2023-03-16,101506,101222,284,0.002797864165665084
498,2023-03-17,107120,106557,563,0.0052557879014189695
499,2023-03-19,7679,7650,29,0.003776533402786821
500,2023-03-20,103349,103071,278,0.002689914754859747
501,2023-03-21,107120,106556,564,0.005265123226288275
502,2023-03-22,7797,7746,51,0.006540977298961139
503,2023-03-23,105491,104935,556,0.0052705918040401555
504,2023-03-24,107120,106560,560,0.005227781926811053
505,2023-03-26,5819,5792,27,0.004639972503866644
506,2023-03-27,107476,107128,348,0.0032379321895120773
507,2023-03-28,99607,99078,529,0.005310871725882719
508,2023-03-29,5818,5791,27,0.004640770024063252
509,2023-03-30,109469,109113,356,0.0032520622276626257
510,2023-03-31,96955,96438,517,0.005332370687432314
