,date,measurements,ok,anomalies,ratio
0,2021-01-04,84261,59326,24935,0.29592575450089603
1,2021-01-07,79762,55938,23824,0.2986885985807778
2,2021-01-11,63952,45146,18806,0.29406429822366775
3,2021-01-14,76608,53724,22884,0.29871553884711777
4,2021-01-18,71775,50887,20888,0.29102055033089513
5,2021-01-21,64518,45746,18772,0.2909575622306953
6,2021-01-25,69400,48817,20583,0.2965850144092219
7,2021-01-28,72540,50625,21915,0.3021091811414392
8,2021-02-01,76546,53972,22574,0.2949076372377394
9,2021-02-04,73220,51414,21806,0.2978148046981699
10,2021-02-08,71941,50447,21494,0.2987726053293671
11,2021-02-11,70940,50067,20873,0.29423456442063717
12,2021-02-15,66441,46998,19443,0.2926355714092202
13,2021-02-18,61929,43787,18142,0.2929483763664842
14,2021-02-22,66128,46658,19470,0.2944289862085652
15,2021-02-25,63581,44953,18628,0.2929806074141646
16,2021-03-01,59055,41905,17150,0.29040724748116165
17,2021-03-17,63304,44658,18646,0.2945469480601542
18,2021-03-22,55183,39101,16082,0.2914303318050849
19,2021-03-25,56289,39942,16347,0.2904119810264883
20,2021-03-29,58025,40963,17062,0.2940456699698406
21,2021-04-01,54718,38759,15959,0.2916590518659308
22,2021-04-05,56062,40006,16056,0.28639720309657163
23,2021-04-06,288,122,166,0.5763888888888888
24,2021-04-08,53477,37550,15927,0.29782897320343327
25,2021-04-12,49025,34893,14132,0.2882610912799592
26,2021-04-15,51166,36211,14955,0.2922839385529453
27,2021-04-19,54176,38310,15866,0.29286030714707617
28,2021-04-22,53307,37717,15590,0.2924569005946686
29,2021-04-26,52632,37408,15224,0.2892536859705122
30,2021-04-29,55187,39259,15928,0.28861869643213073
31,2021-05-03,48961,35345,13616,0.2780988950389085
32,2021-05-06,33404,24102,9302,0.2784696443539696
33,2021-05-10,34138,24634,9504,0.2783994375768938
34,2021-05-13,45985,33011,12974,0.2821354789605306
35,2021-05-17,34593,25011,9582,0.27699245512097825
36,2021-05-20,46236,32814,13422,0.2902932779652219
37,2021-05-23,11430,7997,3433,0.30034995625546806
38,2021-05-24,22985,16615,6370,0.2771372634326735
39,2021-05-26,10639,7439,3200,0.30078014851019835
40,2021-05-27,23922,17301,6621,0.27677451718083773
41,2021-06-03,30225,21596,8629,0.2854921422663358
42,2021-06-06,14105,9813,4292,0.3042892591279688
43,2021-06-07,29697,21247,8450,0.2845405259790551
44,2021-06-09,14098,9754,4344,0.30812881259753155
45,2021-06-10,28196,20337,7859,0.2787274790750461
46,2021-06-13,14112,9823,4289,0.30392573696145125
47,2021-06-14,30240,21735,8505,0.28125
48,2021-06-16,14041,9793,4248,0.3025425539491489
49,2021-06-17,30240,21773,8467,0.27999338624338627
50,2021-06-20,14105,9784,4321,0.3063452676355902
51,2021-06-21,30225,21689,8536,0.28241521918941276
52,2021-06-23,16128,11172,4956,0.3072916666666667
53,2021-06-24,28224,19890,8334,0.29528061224489793
54,2021-06-27,16128,11197,4931,0.30574156746031744
55,2021-06-28,29815,21411,8404,0.28187154117055174
56,2021-06-30,16104,11179,4925,0.3058246398410333
57,2021-07-01,30195,21679,8516,0.282033449246564
58,2021-07-04,16128,11254,4874,0.3022073412698413
59,2021-07-05,30240,21765,8475,0.2802579365079365
60,2021-07-07,14105,9724,4381,0.3105990783410138
61,2021-07-08,28210,20275,7935,0.2812832328961361
62,2021-07-11,16104,11209,4895,0.30396174863387976
63,2021-07-12,30195,21650,8545,0.2829938731578076
64,2021-07-14,16088,11143,4945,0.3073719542516161
65,2021-07-15,28154,20263,7891,0.28027988918093344
66,2021-07-18,15295,10662,4633,0.30290944753187315
67,2021-07-19,28182,20238,7944,0.28188205237385566
68,2021-07-21,14091,9728,4363,0.3096302604499326
69,2021-07-22,26169,18829,7340,0.28048454277962476
70,2021-07-25,16120,11148,4972,0.3084367245657568
71,2021-07-26,26195,18885,7310,0.2790608894827257
72,2021-07-28,14098,9855,4243,0.30096467584054476
73,2021-07-29,26182,18933,7249,0.276869605072187
74,2021-08-01,16128,11158,4970,0.3081597222222222
75,2021-08-02,27198,19516,7682,0.28244723876755645
76,2021-08-04,14098,9673,4425,0.31387430841254077
77,2021-08-05,26182,18794,7388,0.28217859598197237
78,2021-08-08,12096,8333,3763,0.31109457671957674
79,2021-08-09,17386,12809,4577,0.26325779362705626
80,2021-08-11,12108,8277,3831,0.316402378592666
81,2021-08-12,24216,17413,6803,0.2809299636603898
82,2021-08-15,12108,8368,3740,0.3088866864882722
83,2021-08-16,24216,17540,6676,0.2756854971919392
84,2021-08-19,34238,24325,9913,0.28953209883754893
85,2021-08-22,12108,8333,3775,0.31177733729765444
86,2021-08-23,24216,17375,6841,0.28249917409976877
87,2021-08-25,12102,8342,3760,0.310692447529334
88,2021-08-26,24204,17472,6732,0.278135845314824
89,2021-08-29,12108,8324,3784,0.3125206475057813
90,2021-08-30,24216,17402,6814,0.28138420878757847
91,2021-09-02,24192,17485,6707,0.27724041005291006
92,2021-09-05,11332,7872,3460,0.30533003882809745
93,2021-09-06,22187,16140,6047,0.27254698697435437
94,2021-09-08,12072,8326,3746,0.31030483764082173
95,2021-09-09,24144,17439,6705,0.27770874751491054
96,2021-09-12,12084,8355,3729,0.3085898709036743
97,2021-09-13,21880,15854,6026,0.27541133455210237
98,2021-09-15,12090,8343,3747,0.3099255583126551
99,2021-09-16,25856,18492,7364,0.2848081683168317
100,2021-09-19,12096,8380,3716,0.3072089947089947
101,2021-09-20,24750,18034,6716,0.27135353535353535
102,2021-09-22,12090,8361,3729,0.3084367245657568
103,2021-09-23,24194,17487,6707,0.27721749194015044
104,2021-09-26,12102,8345,3757,0.3104445546190712
105,2021-09-27,26221,18920,7301,0.27844094428130123
106,2021-09-29,12096,8297,3799,0.3140707671957672
107,2021-09-30,22988,16379,6609,0.28749782495214893
108,2021-10-03,12102,8346,3756,0.31036192364898363
109,2021-10-04,26221,18731,7490,0.2856489073643263
110,2021-10-06,12090,8393,3697,0.30578990901571546
111,2021-10-07,26195,18944,7251,0.2768085512502386
112,2021-10-10,12102,8375,3727,0.3079656255164436
113,2021-10-11,26221,18809,7412,0.2826741924411731
114,2021-10-13,12096,8397,3699,0.30580357142857145
115,2021-10-14,24418,17631,6787,0.2779506921123761
116,2021-10-17,10095,7086,3009,0.29806835066864784
117,2021-10-18,24228,17592,6636,0.2738979692917286
118,2021-10-20,12090,8310,3780,0.31265508684863524
119,2021-10-21,24180,17366,6814,0.28180314309346566
120,2021-10-24,12102,8411,3691,0.30499091059329037
121,2021-10-25,24635,17846,6789,0.2755835193829917
122,2021-10-27,10085,7029,3056,0.30302429350520577
123,2021-10-28,22187,16130,6057,0.2729977013566503
124,2021-10-31,6054,4221,1833,0.30277502477700696
125,2021-11-01,22198,15942,6256,0.28182719163888637
126,2021-11-03,10075,6990,3085,0.3062034739454094
127,2021-11-04,22165,16131,6034,0.27223099481164
128,2021-11-07,10060,7002,3058,0.30397614314115307
129,2021-11-08,24144,17509,6635,0.2748094764744864
130,2021-11-10,10075,6974,3101,0.3077915632754342
131,2021-11-14,10070,6957,3113,0.3091360476663356
132,2021-11-17,10075,6982,3093,0.30699751861042185
133,2021-11-21,8060,5634,2426,0.3009925558312655
134,2021-11-24,10075,6972,3103,0.30799007444168736
135,2021-12-02,26994,19507,7487,0.2773579313921612
136,2021-12-03,1221,728,493,0.4037674037674038
137,2021-12-05,10075,8793,1282,0.12724565756823822
138,2021-12-06,18135,13289,4846,0.2672180865729253
139,2021-12-08,10060,8755,1305,0.12972166998011928
140,2021-12-09,20120,14615,5505,0.2736083499005964
141,2021-12-12,10070,8769,1301,0.1291956305858987
142,2021-12-13,20140,14590,5550,0.275571002979146
143,2021-12-15,4030,2810,1220,0.3027295285359802
144,2021-12-16,24180,16913,7267,0.30053763440860215
145,2021-12-19,2027,1413,614,0.302910705476073
146,2021-12-20,24168,16966,7202,0.2979973518702416
147,2021-12-22,4028,2805,1223,0.30362462760675274
148,2021-12-23,22908,16120,6788,0.29631569757290027
149,2021-12-26,4030,2769,1261,0.31290322580645163
150,2021-12-27,24180,16952,7228,0.2989247311827957
151,2021-12-29,4024,2721,1303,0.32380715705765406
152,2021-12-30,24144,16710,7434,0.30790258449304175
153,2022-01-02,4028,2784,1244,0.30883813306852037
154,2022-01-03,24168,16942,7226,0.29899040052962594
155,2022-01-05,4026,2776,1250,0.310481867858917
156,2022-01-06,24156,16903,7253,0.30025666501076337
157,2022-01-09,4030,2764,1266,0.3141439205955335
158,2022-01-10,26195,18296,7899,0.30154609658331744
159,2022-01-12,4030,2758,1272,0.31563275434243176
160,2022-01-13,24180,16820,7360,0.304383788254756
161,2022-01-16,4032,2797,1235,0.3062996031746032
162,2022-01-17,26208,18418,7790,0.29723748473748474
163,2022-01-19,4030,2773,1257,0.31191066997518613
164,2022-01-20,24063,16934,7129,0.2962639737356107
165,2022-01-23,4030,2732,1298,0.3220843672456576
166,2022-01-24,24180,16818,7362,0.3044665012406948
167,2022-01-26,4032,2742,1290,0.31994047619047616
168,2022-01-27,26208,18222,7986,0.30471611721611724
169,2022-01-30,4034,2763,1271,0.3150718889439762
170,2022-01-31,26221,18149,8072,0.3078448571755463
171,2022-02-02,4026,2744,1282,0.3184302036761053
172,2022-02-03,26169,18207,7962,0.30425312392525505
173,2022-02-06,2019,1378,641,0.3174839029222387
174,2022-02-07,26247,18416,7831,0.298357907570389
175,2022-02-09,4030,2740,1290,0.3200992555831266
176,2022-02-10,24180,16887,7293,0.3016129032258065
177,2022-02-13,4028,2759,1269,0.31504468718967227
178,2022-02-14,24168,16904,7264,0.3005627275736511
179,2022-02-16,4032,2750,1282,0.3179563492063492
180,2022-02-17,13369,9902,3467,0.25933128880245343
181,2022-02-18,8807,5578,3229,0.3666401725899852
182,2022-02-20,4036,2753,1283,0.3178889990089197
183,2022-02-21,24216,16904,7312,0.3019491245457549
184,2022-02-23,6054,4176,1878,0.31020812685827553
185,2022-02-24,24216,16958,7258,0.2997191939213743
186,2022-02-27,6054,3964,2090,0.3452262966633631
187,2022-02-28,22198,14781,7417,0.3341292008289035
188,2022-03-02,6036,4021,2015,0.3338303512259775
189,2022-03-03,24144,16365,7779,0.32219184890656066
190,2022-03-06,6039,4017,2022,0.33482364629905614
191,2022-03-07,24156,16297,7859,0.3253435999337639
192,2022-03-09,5120,3458,1662,0.324609375
193,2022-03-10,24168,16444,7724,0.3195961602118504
194,2022-03-13,6054,4116,1938,0.3201189296333003
195,2022-03-14,24216,16301,7915,0.3268500165180046
196,2022-03-16,5170,3525,1645,0.3181818181818182
197,2022-03-17,23334,15997,7337,0.3144338733179052
198,2022-03-20,5297,3610,1687,0.3184821597130451
199,2022-03-21,22165,14877,7288,0.328806677193774
200,2022-03-23,4185,2822,1363,0.3256869772998805
201,2022-03-24,18126,12229,5897,0.32533377468829305
202,2022-03-27,2696,1894,802,0.29747774480712164
203,2022-03-28,16120,10870,5250,0.32568238213399503
204,2022-03-30,4030,2750,1280,0.3176178660049628
205,2022-03-31,18135,12238,5897,0.32517231872070584
206,2022-04-03,4028,2729,1299,0.3224925521350546
207,2022-04-04,18126,12161,5965,0.32908529184596713
208,2022-04-06,4024,2747,1277,0.3173459244532803
209,2022-04-07,18108,12196,5912,0.32648553125690305
210,2022-04-10,4028,2729,1299,0.3224925521350546
211,2022-04-11,18126,12130,5996,0.33079554231490677
212,2022-04-13,4026,2750,1276,0.31693989071038253
213,2022-04-14,18117,12282,5835,0.32207319092564995
214,2022-04-17,4032,2717,1315,0.326140873015873
215,2022-04-18,18144,12099,6045,0.3331679894179894
216,2022-04-20,4026,2758,1268,0.31495280675608545
217,2022-04-21,18117,12246,5871,0.324060274879947
218,2022-04-24,2014,1393,621,0.3083416087388282
219,2022-04-25,2014,1328,686,0.34061569016881826
220,2022-04-28,7304,5152,2152,0.2946330777656079
221,2022-04-29,6773,4404,2369,0.3497711501550273
222,2022-05-01,6042,4083,1959,0.3242303872889772
223,2022-05-02,22154,14735,7419,0.3348830910896452
224,2022-05-04,6045,4113,1932,0.3196029776674938
225,2022-05-05,22165,14813,7352,0.33169411233927365
226,2022-05-08,2014,1553,461,0.22889771598808342
227,2022-05-09,2014,1393,621,0.3083416087388282
228,2022-05-11,2010,1555,455,0.2263681592039801
229,2022-05-12,2010,1401,609,0.3029850746268657
230,2022-05-15,2005,1599,406,0.2024937655860349
231,2022-05-16,2005,1446,559,0.2788029925187032
232,2022-05-18,2003,1581,422,0.2106839740389416
233,2022-05-19,2003,1452,551,0.27508736894658015
234,2022-05-22,2003,1579,424,0.21168247628557163
235,2022-05-23,2003,1452,551,0.27508736894658015
236,2022-05-25,2003,1568,435,0.21717423864203694
237,2022-05-26,2003,1454,549,0.2740888666999501
238,2022-05-29,2003,1593,410,0.20469296055916125
239,2022-05-30,2003,1452,551,0.27508736894658015
240,2022-06-01,2003,1572,431,0.21517723414877685
241,2022-06-02,2003,1454,549,0.2740888666999501
242,2022-06-05,2003,1572,431,0.21517723414877685
243,2022-06-08,757,621,136,0.17965653896961692
244,2022-06-09,2003,1449,554,0.2765851223165252
245,2022-06-13,2001,1465,536,0.26786606696651677
246,2022-06-16,2003,1473,530,0.2646030953569646
247,2022-06-20,2002,1470,532,0.26573426573426573
248,2022-06-23,2002,1476,526,0.2627372627372627
249,2022-06-27,2017,1489,528,0.2617749132374814
250,2022-06-30,2017,1487,530,0.2627664848785325
251,2022-07-04,2017,1482,535,0.26524541398116014
252,2022-07-07,2019,1492,527,0.26102030708271423
253,2022-07-11,2019,1460,559,0.27686973749380883
254,2022-07-14,2019,1493,526,0.2605250123823675
255,2022-07-18,2019,1492,527,0.26102030708271423
256,2022-07-21,2019,1493,526,0.2605250123823675
257,2022-07-25,2019,1497,522,0.2585438335809807
258,2022-07-28,2019,1493,526,0.2605250123823675
259,2022-08-01,2019,1481,538,0.266468548786528
260,2022-08-04,1029,804,225,0.21865889212827988
261,2022-08-08,2019,1495,524,0.2595344229816741
262,2022-08-11,2020,1492,528,0.2613861386138614
263,2022-08-15,2020,1492,528,0.2613861386138614
264,2022-08-18,1905,1393,512,0.26876640419947506
265,2022-08-22,2020,1492,528,0.2613861386138614
266,2022-08-25,2020,1491,529,0.2618811881188119
267,2022-09-12,2022,1498,524,0.2591493570722057
268,2022-09-15,2018,1491,527,0.26114965312190286
269,2022-09-19,2019,1490,529,0.26201089648340764
270,2022-09-22,2018,1482,536,0.26560951437066405
271,2022-09-26,417,299,118,0.2829736211031175
272,2022-09-29,2019,1478,541,0.2679544328875681
273,2022-10-03,2018,1470,548,0.27155599603567887
274,2022-10-06,2018,1465,553,0.27403369672943506
275,2022-10-10,2018,1461,557,0.27601585728444006
276,2022-10-13,24216,17658,6558,0.270812685827552
277,2022-10-19,11645,8161,3484,0.2991841992271361
278,2022-10-20,26234,19031,7203,0.27456735534039794
279,2022-10-23,10095,7016,3079,0.30500247647350176
280,2022-10-24,26247,18906,7341,0.2796891073265516
281,2022-10-26,10095,6999,3096,0.30668647845468056
282,2022-10-27,26247,18930,7317,0.2787747171105269
283,2022-10-30,11683,8082,3601,0.3082256269793717
284,2022-10-31,26247,18803,7444,0.2836133653369909
285,2022-11-02,10095,6956,3139,0.3109460128776622
286,2022-11-03,24955,18306,6649,0.2664395912642757
287,2022-11-06,10964,7748,3216,0.2933236045238964
288,2022-11-07,22231,16642,5589,0.2514056947505735
289,2022-11-09,10105,7154,2951,0.29203364670954973
290,2022-11-10,24252,17962,6290,0.25936005277915225
291,2022-11-13,9796,6939,2857,0.291649652919559
292,2022-11-14,24264,17922,6342,0.2613748763600396
293,2022-11-16,11536,8210,3326,0.2883148404993065
294,2022-11-17,26273,19381,6892,0.26232253644425835
295,2022-11-20,11342,7888,3454,0.30453182860165756
296,2022-11-21,24533,18115,6418,0.26160681530999064
297,2022-11-23,10110,7173,2937,0.2905044510385757
298,2022-11-24,24264,17989,6275,0.2586135839103198
299,2022-11-27,10115,7164,2951,0.2917449332674246
300,2022-11-28,23602,17501,6101,0.25849504279298363
301,2022-11-30,10105,7186,2919,0.2888668975754577
302,2022-12-01,24252,17954,6298,0.2596899224806202
303,2022-12-04,10105,7168,2937,0.2906481939633845
304,2022-12-05,24252,17965,6287,0.25923635164110176
305,2022-12-07,10105,7156,2949,0.291835724888669
306,2022-12-08,24252,17934,6318,0.26051459673428995
307,2022-12-11,10110,7221,2889,0.2857566765578635
308,2022-12-12,22242,16491,5751,0.25856487725923927
309,2022-12-14,10105,7151,2954,0.29233052944087085
310,2022-12-15,24252,17920,6332,0.2610918687118588
311,2022-12-18,10110,7158,2952,0.29198813056379824
312,2022-12-19,24264,17969,6295,0.25943785031322125
313,2022-12-21,10115,7170,2945,0.2911517548195749
314,2022-12-22,24276,18018,6258,0.2577854671280277
315,2022-12-25,20240,14316,5924,0.2926877470355731
316,2022-12-26,24288,17937,6351,0.26148715415019763
317,2022-12-28,10115,7178,2937,0.2903608502224419
318,2022-12-29,24276,18016,6260,0.25786785302356235
319,2023-01-01,6069,4399,1670,0.2751688910858461
320,2023-01-02,28322,20774,7548,0.2665066026410564
321,2023-01-04,6069,4405,1664,0.2741802603394299
322,2023-01-05,28322,20767,7555,0.26675376032766046
323,2023-01-08,6069,4399,1670,0.2751688910858461
324,2023-01-09,30345,22321,8024,0.26442577030812325
325,2023-01-11,8092,5642,2450,0.3027681660899654
326,2023-01-12,32400,23813,8587,0.26503086419753086
327,2023-01-15,6069,4326,1743,0.28719723183391005
328,2023-01-16,30345,22135,8210,0.27055528093590375
329,2023-01-18,8092,5867,2225,0.2749629263470094
330,2023-01-19,30360,22058,8302,0.27345191040843214
331,2023-01-22,8092,5869,2223,0.2747157686604053
332,2023-01-23,32384,23524,8860,0.2735918972332016
333,2023-01-25,8518,6719,1799,0.21119981216247946
334,2023-01-26,30345,22184,8161,0.26894051738342395
335,2023-01-29,8694,6826,1868,0.21486082355647573
336,2023-01-30,24264,17874,6390,0.263353115727003
337,2023-02-01,9663,6952,2711,0.2805546931594743
338,2023-02-02,20631,15228,5403,0.26188745092336774
339,2023-02-05,10132,7895,2237,0.22078562968811685
340,2023-02-06,26793,19579,7214,0.2692494308214832
341,2023-02-08,8092,5842,2250,0.27805239742956006
342,2023-02-09,26793,19568,7225,0.2696599858171911
343,2023-02-12,8092,5797,2295,0.28361344537815125
344,2023-02-13,34039,24774,9265,0.27218778460001763
345,2023-02-15,8092,6273,1819,0.22478991596638656
346,2023-02-16,30900,22614,8286,0.26815533980582523
347,2023-02-19,8092,6391,1701,0.2102076124567474
348,2023-02-20,33709,25079,8630,0.25601471417128957
349,2023-02-22,8092,6403,1689,0.20872466633712308
350,2023-02-23,30900,23077,7823,0.2531715210355987
351,2023-02-26,8092,6380,1712,0.2115669797330697
352,2023-02-27,32003,23859,8144,0.25447614286160675
353,2023-03-01,8092,6392,1700,0.21008403361344538
354,2023-03-02,22478,17163,5315,0.2364534211228757
355,2023-03-03,8422,5987,2435,0.2891237235810971
356,2023-03-05,8092,6392,1700,0.21008403361344538
357,2023-03-06,31993,23952,8041,0.2513362298002688
358,2023-03-08,8092,6398,1694,0.2093425605536332
359,2023-03-09,30900,23174,7726,0.2500323624595469
360,2023-03-12,8092,6370,1722,0.21280276816608998
361,2023-03-13,32136,24022,8114,0.2524894199651481
362,2023-03-15,8092,6369,1723,0.212926347009392
363,2023-03-16,30900,22982,7918,0.2562459546925566
364,2023-03-19,6069,4943,1126,0.1855330367441094
365,2023-03-20,31980,23789,8191,0.2561288305190744
366,2023-03-22,8092,6378,1714,0.21181413741967375
367,2023-03-23,30900,22966,7934,0.25676375404530744
368,2023-03-26,8092,6376,1716,0.2120612951062778
369,2023-03-27,34040,25220,8820,0.2591069330199765
370,2023-03-29,8092,6372,1720,0.2125556104794859
371,2023-03-30,32960,24423,8537,0.2590109223300971
