,date,measurements,ok,anomalies,ratio
0,2021-01-03,72816,68174,4642,0.06374972533509118
1,2021-01-04,10734,10077,657,0.061207378423700394
2,2021-01-06,77991,73195,4796,0.06149427498044646
3,2021-01-07,10060,9431,629,0.06252485089463221
4,2021-01-10,77009,72115,4894,0.0635510135179005
5,2021-01-11,14112,13250,862,0.0610827664399093
6,2021-01-13,73098,68462,4636,0.06342170784426386
7,2021-01-14,14112,13232,880,0.06235827664399093
8,2021-01-17,82017,76742,5275,0.06431593450138386
9,2021-01-18,10085,9483,602,0.05969261279127417
10,2021-01-20,83420,78215,5205,0.06239510908654999
11,2021-01-21,10080,9492,588,0.058333333333333334
12,2021-01-24,88560,82861,5699,0.06435185185185185
13,2021-01-25,2017,1895,122,0.06048587010411502
14,2021-01-27,81217,75876,5341,0.06576209414285186
15,2021-01-28,2015,1892,123,0.06104218362282878
16,2021-01-31,73162,68362,4800,0.06560782920095132
17,2021-02-01,12108,11398,710,0.0586389164188966
18,2021-02-03,67189,62784,4405,0.06556132700293203
19,2021-02-04,12084,11347,737,0.06098973849718636
20,2021-02-07,67779,63447,4332,0.0639136015580047
21,2021-02-08,14098,13137,961,0.06816569726202298
22,2021-02-10,67395,63014,4381,0.06500482231619556
23,2021-02-11,14098,13135,963,0.06830756135622074
24,2021-02-14,74784,70337,4447,0.05946459135643988
25,2021-02-15,8072,7585,487,0.06033201189296333
26,2021-02-17,69181,64468,4713,0.06812564143334153
27,2021-02-18,8064,7577,487,0.06039186507936508
28,2021-02-21,68995,64455,4540,0.06580186970070295
29,2021-02-22,10080,9470,610,0.060515873015873016
30,2021-02-24,70848,66175,4673,0.06595810749774164
31,2021-02-25,55,48,7,0.12727272727272726
32,2021-02-28,68880,64357,4523,0.06566492450638792
33,2021-03-01,4032,3787,245,0.06076388888888889
34,2021-03-17,64448,60388,4060,0.06299652432969216
35,2021-03-18,8875,8341,534,0.06016901408450704
36,2021-03-21,73061,68567,4494,0.06151024486388087
37,2021-03-22,4032,3794,238,0.059027777777777776
38,2021-03-24,68541,64360,4181,0.06099998541019244
39,2021-03-25,4028,3790,238,0.05908639523336644
40,2021-03-28,67987,63739,4248,0.062482533425507816
41,2021-03-29,14098,13242,856,0.06071783231664066
42,2021-04-01,14105,13256,849,0.06019142148174406
43,2021-04-04,66561,62530,4031,0.060560989167831016
44,2021-04-05,16136,15191,945,0.05856470004957858
45,2021-04-06,80,64,16,0.2
46,2021-04-07,70490,66138,4352,0.06173925379486452
47,2021-04-08,16112,15162,950,0.0589622641509434
48,2021-04-11,72545,68107,4438,0.06117582190364601
49,2021-04-12,8386,7886,500,0.059623181492964465
50,2021-04-14,71756,67317,4439,0.06186242265455154
51,2021-04-15,10065,9472,593,0.0589170392449081
52,2021-04-18,78546,73884,4662,0.05935375448781606
53,2021-04-19,10070,9478,592,0.058788480635551144
54,2021-04-21,76532,71971,4561,0.05959598599278733
55,2021-04-22,10070,9482,588,0.058391261171797416
56,2021-04-25,10083,9504,579,0.057423385897054445
57,2021-04-26,63627,59913,3714,0.058371446084209536
58,2021-04-28,10057,9462,595,0.05916277219846873
59,2021-04-29,70367,65994,4373,0.06214560802648969
60,2021-05-02,70530,66297,4233,0.06001701403658018
61,2021-05-03,12074,11378,696,0.05764452542653636
62,2021-05-05,65394,61405,3989,0.060999480074624586
63,2021-05-06,14109,13273,836,0.05925295910411794
64,2021-05-09,77569,72840,4729,0.060965076254689374
65,2021-05-10,6256,5888,368,0.058823529411764705
66,2021-05-12,82163,76974,5189,0.06315494809098986
67,2021-05-13,7163,6753,410,0.057238587184140724
68,2021-05-16,87295,81880,5415,0.06203104416060484
69,2021-05-19,86806,81348,5458,0.06287583807570905
70,2021-05-23,24173,22563,1610,0.06660323501427212
71,2021-05-24,57452,54045,3407,0.0593016779224396
72,2021-05-26,18042,16793,1249,0.06922735838598824
73,2021-05-27,50195,47107,3088,0.061520071720290864
74,2021-05-30,59527,55953,3574,0.060039981856972464
75,2021-06-03,58435,54870,3565,0.0610079575596817
76,2021-06-06,18135,16848,1287,0.07096774193548387
77,2021-06-07,62465,58603,3862,0.06182662290882895
78,2021-06-09,20032,18618,1414,0.0705870607028754
79,2021-06-10,58686,55058,3628,0.06182053641413625
80,2021-06-13,20160,18778,1382,0.06855158730158731
81,2021-06-14,60480,56806,3674,0.060747354497354494
82,2021-06-16,20375,18973,1402,0.06880981595092024
83,2021-06-17,62496,58783,3713,0.05941180235535074
84,2021-06-20,22165,20655,1510,0.06812542296413264
85,2021-06-21,60450,56798,3652,0.060413564929693964
86,2021-06-23,21846,20360,1486,0.06802160578595624
87,2021-06-24,62006,58268,3738,0.06028448859787763
88,2021-06-27,20160,18731,1429,0.0708829365079365
89,2021-06-28,59745,56036,3709,0.06208050882919073
90,2021-06-30,18981,17657,1324,0.06975396449080659
91,2021-07-01,60390,56608,3782,0.06262626262626263
92,2021-07-04,20160,18747,1413,0.07008928571428572
93,2021-07-05,62496,58582,3914,0.06262800819252431
94,2021-07-07,19490,18078,1412,0.07244740892765521
95,2021-07-08,56420,52861,3559,0.0630804679191776
96,2021-07-11,20130,18707,1423,0.07069051167411823
97,2021-07-12,58377,54737,3640,0.062353324083114926
98,2021-07-14,19160,17778,1382,0.0721294363256785
99,2021-07-15,53183,49899,3284,0.061749055149201815
100,2021-07-18,20130,18661,1469,0.07297565822155987
101,2021-07-19,57390,53786,3604,0.06279839693326364
102,2021-07-21,20130,18665,1465,0.07277694982613016
103,2021-07-22,61701,57727,3974,0.06440738399701787
104,2021-07-25,20150,18650,1500,0.07444168734491315
105,2021-07-26,62465,58346,4119,0.06594092691907469
106,2021-07-28,17943,16606,1337,0.07451373794794627
107,2021-07-29,57026,53279,3747,0.06570687055027531
108,2021-08-01,20160,18688,1472,0.07301587301587302
109,2021-08-02,58464,54758,3706,0.06338943623426382
110,2021-08-04,20140,18636,1504,0.0746772591857001
111,2021-08-05,60420,56542,3878,0.06418404501820589
112,2021-08-08,20160,18714,1446,0.07172619047619047
113,2021-08-09,56448,52934,3514,0.06225198412698413
114,2021-08-11,20180,18722,1458,0.07224975222993063
115,2021-08-12,60394,56664,3730,0.06176110209623473
116,2021-08-15,18162,16842,1320,0.07267922035018169
117,2021-08-16,55057,51780,3277,0.059520133679641096
118,2021-08-19,78546,73429,5117,0.06514653833422453
119,2021-08-22,18162,16847,1315,0.07240392027309768
120,2021-08-23,58522,55066,3456,0.05905471446635453
121,2021-08-25,17430,16147,1283,0.07360872059667241
122,2021-08-26,59111,55541,3570,0.060394850366260085
123,2021-08-29,18162,16835,1327,0.07306464045809932
124,2021-08-30,60196,56540,3656,0.06073493255365805
125,2021-09-02,58464,55049,3415,0.05841201423097975
126,2021-09-05,18153,16868,1285,0.07078719770836776
127,2021-09-06,58493,54949,3544,0.06058844648077548
128,2021-09-08,16096,14931,1165,0.07237823061630219
129,2021-09-09,55679,52762,2917,0.052389590330286104
130,2021-09-12,18126,16846,1280,0.07061679355621758
131,2021-09-13,55046,51976,3070,0.05577153653308142
132,2021-09-15,18135,16867,1268,0.0699200441135925
133,2021-09-16,61349,58012,3337,0.054393714648975536
134,2021-09-19,18144,16910,1234,0.06801146384479718
135,2021-09-20,60480,57139,3341,0.05524140211640212
136,2021-09-22,17345,16125,1220,0.07033727298933411
137,2021-09-23,59380,56067,3313,0.05579319636241158
138,2021-09-26,18153,17091,1062,0.05850272682201289
139,2021-09-27,60510,57470,3040,0.05023962981325401
140,2021-09-29,16050,14597,1453,0.09052959501557632
141,2021-09-30,57183,53825,3358,0.05872374656803595
142,2021-10-03,16274,15225,1049,0.06445864569251566
143,2021-10-04,54459,51805,2654,0.048733909913880165
144,2021-10-06,18135,17057,1078,0.0594430658946788
145,2021-10-07,56420,53996,2424,0.042963488124778446
146,2021-10-10,16547,15724,823,0.04973711246751677
147,2021-10-11,60510,57725,2785,0.04602545033878698
148,2021-10-13,17167,16288,879,0.05120288926428613
149,2021-10-14,61541,58567,2974,0.04832550657285387
150,2021-10-17,16152,15278,874,0.054110946012877664
151,2021-10-18,62064,59392,2672,0.04305233307553493
152,2021-10-20,18135,17151,984,0.05425971877584781
153,2021-10-21,59495,56949,2546,0.04279351205983696
154,2021-10-24,16136,15173,963,0.05968021814576103
155,2021-10-25,59028,56419,2609,0.044199363014162774
156,2021-10-27,18153,17191,962,0.052993995482840305
157,2021-10-28,60605,58061,2544,0.04197673459285538
158,2021-10-31,14126,13269,857,0.06066827127283024
159,2021-11-01,56735,54332,2403,0.042354807438089365
160,2021-11-03,16120,15151,969,0.06011166253101737
161,2021-11-04,62465,59683,2782,0.0445369406867846
162,2021-11-07,14753,13887,866,0.05869992543889378
163,2021-11-08,58348,55771,2577,0.044166038253239184
164,2021-11-10,16120,15173,947,0.05874689826302729
165,2021-11-14,16112,15242,870,0.053997020854021846
166,2021-11-17,15598,14723,875,0.056096935504551866
167,2021-11-21,16120,14973,1147,0.07115384615384615
168,2021-11-24,16120,15007,1113,0.06904466501240694
169,2021-12-02,72548,69040,3508,0.048354193085956884
170,2021-12-05,16120,15060,1060,0.06575682382133995
171,2021-12-06,55244,51246,3998,0.07236985011946999
172,2021-12-08,15372,14122,1250,0.08131667967733541
173,2021-12-09,52312,48507,3805,0.07273665698118978
174,2021-12-12,15156,13510,1646,0.10860385325943521
175,2021-12-13,54072,50277,3795,0.07018419884598313
176,2021-12-15,25806,24084,1722,0.06672866775168565
177,2021-12-16,19854,18500,1354,0.06819784426312078
178,2021-12-19,26182,24223,1959,0.07482239706668704
179,2021-12-20,18126,16848,1278,0.070506454816286
180,2021-12-22,25645,23507,2138,0.0833690777929421
181,2021-12-23,14514,13501,1013,0.06979468099765744
182,2021-12-26,21765,19178,2587,0.11886055593843327
183,2021-12-27,16120,14561,1559,0.096712158808933
184,2021-12-29,26156,24260,1896,0.07248814803486772
185,2021-12-30,17777,16472,1305,0.0734094616639478
186,2022-01-02,26182,24276,1906,0.07279810556871133
187,2022-01-03,18126,16738,1388,0.07657508551252344
188,2022-01-05,30195,28172,2023,0.06699784732571618
189,2022-01-06,17755,16703,1052,0.05925091523514503
190,2022-01-09,30225,28225,2000,0.06617038875103391
191,2022-01-10,16120,15218,902,0.05595533498759305
192,2022-01-12,29677,27647,2030,0.06840314047915895
193,2022-01-13,16269,14740,1529,0.09398242055442867
194,2022-01-16,30240,28141,2099,0.06941137566137566
195,2022-01-17,18016,16646,1370,0.07604351687388988
196,2022-01-19,30225,28132,2093,0.06924731182795699
197,2022-01-20,13862,12860,1002,0.0722839417111528
198,2022-01-23,30225,28090,2135,0.07063688999172871
199,2022-01-24,16120,14855,1265,0.07847394540942929
200,2022-01-26,30020,27880,2140,0.07128580946035976
201,2022-01-27,15920,14695,1225,0.07694723618090452
202,2022-01-30,26221,24378,1843,0.07028717440219671
203,2022-01-31,16136,14906,1230,0.07622706990580069
204,2022-02-02,24156,22473,1683,0.06967213114754098
205,2022-02-03,14826,13699,1127,0.07601510859301228
206,2022-02-06,26247,24425,1822,0.06941745723320761
207,2022-02-07,16152,14927,1225,0.0758420009905894
208,2022-02-09,26195,24314,1881,0.0718075968696316
209,2022-02-10,15832,14631,1201,0.07585901970692269
210,2022-02-13,24168,22560,1608,0.06653426017874876
211,2022-02-14,16112,14890,1222,0.07584409136047666
212,2022-02-16,25675,23906,1769,0.06889970788704966
213,2022-02-17,10967,10353,614,0.055986140238898516
214,2022-02-18,5578,4916,662,0.11868053065614916
215,2022-02-20,26234,24443,1791,0.06827018373103606
216,2022-02-21,13805,12817,988,0.07156827236508512
217,2022-02-23,26234,24599,1635,0.0623237020660212
218,2022-02-24,14126,13094,1032,0.07305677474161121
219,2022-02-27,26234,24024,2210,0.08424182358771061
220,2022-02-28,16144,14550,1594,0.09873637264618434
221,2022-03-02,25680,23710,1970,0.07671339563862928
222,2022-03-03,18108,16407,1701,0.09393638170974156
223,2022-03-06,24564,22685,1879,0.0764940563426152
224,2022-03-07,18117,16402,1715,0.09466247171165204
225,2022-03-09,26182,24148,2034,0.0776869605072187
226,2022-03-10,14098,12932,1166,0.08270676691729323
227,2022-03-13,26234,24160,2074,0.07905771136692841
228,2022-03-14,16990,15326,1664,0.09793996468510889
229,2022-03-16,26182,24293,1889,0.07214880452219082
230,2022-03-17,8844,8170,674,0.07620985979194934
231,2022-03-20,22165,20383,1782,0.0803970223325062
232,2022-03-21,8060,7397,663,0.08225806451612903
233,2022-03-23,24168,22264,1904,0.07878186031115525
234,2022-03-24,10070,9326,744,0.07388282025819265
235,2022-03-27,26195,24255,1940,0.07405993510211872
236,2022-03-28,10075,9307,768,0.07622828784119107
237,2022-03-30,21984,20375,1609,0.0731895924308588
238,2022-03-31,10229,9434,795,0.07772020725388601
239,2022-04-03,22154,20375,1779,0.08030152568384942
240,2022-04-04,10070,9259,811,0.08053624627606752
241,2022-04-06,22132,20363,1769,0.0799295138261341
242,2022-04-07,12072,11175,897,0.07430417495029822
243,2022-04-10,22154,20282,1872,0.08449941319851946
244,2022-04-11,10070,9226,844,0.08381330685203575
245,2022-04-13,21437,19747,1690,0.07883565797453002
246,2022-04-14,10065,9260,805,0.07998012916045703
247,2022-04-17,22176,20236,1940,0.08748196248196248
248,2022-04-18,10080,9197,883,0.08759920634920634
249,2022-04-20,21591,19820,1771,0.08202491778981984
250,2022-04-21,12078,11090,988,0.08180162278522934
251,2022-04-24,2014,1842,172,0.08540218470705065
252,2022-04-25,16224,14695,1529,0.0942430966469428
253,2022-04-27,20110,18606,1504,0.0747886623570363
254,2022-04-28,6667,6260,407,0.06104694765261737
255,2022-04-29,5399,4886,513,0.09501759585108353
256,2022-05-01,22154,20307,1847,0.08337094881285546
257,2022-05-02,12084,11115,969,0.08018867924528301
258,2022-05-04,20484,18826,1658,0.08094122241749659
259,2022-05-05,12090,11135,955,0.07899090157154673
260,2022-05-08,29568,27465,2103,0.0711241883116883
261,2022-05-09,30210,27522,2688,0.08897715988083416
262,2022-05-11,30150,28261,1889,0.06265339966832505
263,2022-05-12,32160,29607,2553,0.07938432835820895
264,2022-05-15,28589,26849,1740,0.060862569519745356
265,2022-05-16,30075,27831,2244,0.07461346633416459
266,2022-05-18,28183,26582,1601,0.05680729517794415
267,2022-05-19,30045,27873,2172,0.07229156265601598
268,2022-05-22,30045,28335,1710,0.05691462805791313
269,2022-05-23,30045,27828,2217,0.07378931602596106
270,2022-05-25,29279,27638,1641,0.05604699614057857
271,2022-05-26,30045,28057,1988,0.06616741554335163
272,2022-05-29,30045,28326,1719,0.05721417873190215
273,2022-05-30,32894,30488,2406,0.07314403842646075
274,2022-06-01,30045,28281,1764,0.058711932101847226
275,2022-06-02,33985,31578,2407,0.07082536413123437
276,2022-06-05,30045,28284,1761,0.058612081877184224
277,2022-06-06,36054,33463,2591,0.07186442558384645
278,2022-06-08,29807,28085,1722,0.0577716643741403
279,2022-06-09,34875,32375,2500,0.07168458781362007
280,2022-06-12,30015,28272,1743,0.05807096451774113
281,2022-06-13,34390,31919,2471,0.07185228264030241
282,2022-06-15,30045,28224,1821,0.060609086370444334
283,2022-06-16,36054,33381,2673,0.07413879181228157
284,2022-06-19,30030,28235,1795,0.059773559773559776
285,2022-06-20,33935,31468,2467,0.07269780462649182
286,2022-06-22,30030,28245,1785,0.05944055944055944
287,2022-06-23,34034,31543,2491,0.07319151436798496
288,2022-06-26,30255,28431,1824,0.06028755577590481
289,2022-06-27,36306,33639,2667,0.07345893240786647
290,2022-06-29,30255,28424,1831,0.06051892249215006
291,2022-06-30,37477,34742,2735,0.07297809323051471
292,2022-07-03,30255,28449,1806,0.05969261279127417
293,2022-07-04,38065,35179,2886,0.07581768028372521
294,2022-07-06,30285,28515,1770,0.05844477464091134
295,2022-07-07,36190,33577,2613,0.0722022658192871
296,2022-07-10,19640,18821,819,0.04170061099796334
297,2022-07-11,31528,29260,2268,0.0719360568383659
298,2022-07-13,29170,27491,1679,0.057559136098731575
299,2022-07-14,38099,35402,2697,0.07078925956061839
300,2022-07-17,28266,26727,1539,0.054447038845255785
301,2022-07-18,35355,33018,2337,0.06610097581671616
302,2022-07-20,27138,25645,1493,0.05501510796668878
303,2022-07-21,36342,33886,2456,0.06758021022508393
304,2022-07-24,26247,24824,1423,0.05421571989179716
305,2022-07-25,35887,33445,2442,0.06804692507035974
306,2022-07-27,26247,24766,1481,0.056425496247190156
307,2022-07-28,36342,33857,2485,0.06837818502008695
308,2022-07-31,24629,23268,1361,0.05526005927971091
309,2022-08-01,36342,33886,2456,0.06758021022508393
310,2022-08-03,26247,24787,1460,0.05562540480816855
311,2022-08-04,31466,29344,2122,0.06743786944638658
312,2022-08-07,26247,24817,1430,0.05448241703813769
313,2022-08-08,36342,33877,2465,0.06782785757525728
314,2022-08-10,25887,24466,1421,0.05489241704330359
315,2022-08-11,33420,31075,2345,0.07016756433273488
316,2022-08-14,22220,21040,1180,0.05310531053105311
317,2022-08-15,36232,33658,2574,0.07104217266504748
318,2022-08-17,23408,22005,1403,0.059936773752563226
319,2022-08-18,33612,31237,2375,0.07065928834939902
320,2022-08-21,20200,19091,1109,0.0549009900990099
321,2022-08-22,32448,30059,2389,0.07362549309664694
322,2022-08-24,23969,22609,1360,0.05673995577621094
323,2022-08-25,37960,35177,2783,0.07331401475237091
324,2022-08-28,24240,22860,1380,0.05693069306930693
325,2022-08-29,37764,35056,2708,0.07170850545493063
326,2022-08-31,24240,22854,1386,0.05717821782178218
327,2022-09-01,38380,35501,2879,0.07501302761855133
328,2022-09-04,24264,22868,1396,0.057533794922518956
329,2022-09-05,32920,30476,2444,0.07424058323207776
330,2022-09-07,24032,22637,1395,0.05804760319573901
331,2022-09-08,34194,31700,2494,0.07293677253319296
332,2022-09-11,24264,22871,1393,0.057410154962083744
333,2022-09-12,36396,33771,2625,0.07212331025387406
334,2022-09-14,22198,20945,1253,0.056446526714118386
335,2022-09-15,36324,33650,2674,0.07361524061226737
336,2022-09-18,24228,22819,1409,0.058155852732375765
337,2022-09-19,34323,31811,2512,0.07318707572181919
338,2022-09-21,24062,22694,1368,0.05685312941567617
339,2022-09-22,36016,33408,2608,0.07241226121723679
340,2022-09-25,24240,22882,1358,0.05602310231023102
341,2022-09-26,30888,28784,2104,0.06811706811706812
342,2022-09-28,24228,22871,1357,0.05600957569754004
343,2022-09-29,27516,25674,1842,0.06694286960313998
344,2022-10-02,24216,22854,1362,0.05624380574826561
345,2022-10-03,30270,28140,2130,0.07036669970267592
346,2022-10-05,24216,22806,1410,0.058225966303270565
347,2022-10-06,30270,28128,2142,0.07076313181367691
348,2022-10-09,24216,22839,1377,0.05686323092170466
349,2022-10-10,32288,29773,2515,0.07789271555996036
350,2022-10-12,22380,21126,1254,0.05603217158176944
351,2022-10-13,24216,22546,1670,0.0689626693095474
352,2022-10-19,18162,16836,1326,0.07300958044268252
353,2022-10-20,23896,22177,1719,0.07193672581185136
354,2022-10-23,18171,16911,1260,0.06934125804853888
355,2022-10-24,28266,26210,2056,0.07273756456520201
356,2022-10-26,16152,15005,1147,0.07101287766220901
357,2022-10-27,25971,23915,2056,0.0791652227484502
358,2022-10-30,18171,16924,1247,0.0686258323702603
359,2022-10-31,24228,22572,1656,0.06835066864784546
360,2022-11-02,17610,16379,1231,0.06990346394094264
361,2022-11-03,25581,23617,1964,0.07677573198858528
362,2022-11-06,16168,15073,1095,0.06772637308263237
363,2022-11-07,28294,26306,1988,0.070262246412667
364,2022-11-09,18189,16953,1236,0.06795315850239156
365,2022-11-10,23424,21868,1556,0.0664275956284153
366,2022-11-13,18198,16957,1241,0.06819430706671063
367,2022-11-14,26286,24421,1865,0.07095031575743742
368,2022-11-16,18189,16943,1246,0.06850294133817142
369,2022-11-17,26273,24485,1788,0.06805465687207399
370,2022-11-20,18189,16951,1238,0.06806311506954753
371,2022-11-21,24252,22557,1695,0.06989114299851559
372,2022-11-23,16176,15058,1118,0.06911473788328387
373,2022-11-24,20220,18815,1405,0.06948565776458951
374,2022-11-27,16184,15083,1101,0.06803015323776569
375,2022-11-28,20230,18751,1479,0.073109243697479
376,2022-11-30,16168,15053,1115,0.06896338446313706
377,2022-12-01,20210,18741,1469,0.07268678871845621
378,2022-12-04,15132,14118,1014,0.06701030927835051
379,2022-12-05,18189,16932,1257,0.06910770245752927
380,2022-12-07,14147,13175,972,0.06870714639146108
381,2022-12-08,19500,18125,1375,0.07051282051282051
382,2022-12-11,14154,13192,962,0.06796665253638548
383,2022-12-12,18198,16945,1253,0.06885372018903176
384,2022-12-14,10156,9442,714,0.07030326900354471
385,2022-12-15,18189,16939,1250,0.06872285447248337
386,2022-12-18,12132,11314,818,0.06742499175733598
387,2022-12-19,16176,15055,1121,0.06930019782393669
388,2022-12-21,14161,13199,962,0.06793305557517125
389,2022-12-22,17253,16092,1161,0.06729264475743349
390,2022-12-25,21044,19594,1450,0.06890325033263638
391,2022-12-26,18216,16964,1252,0.06873078612209046
392,2022-12-28,10115,9412,703,0.06950074147305982
393,2022-12-29,18207,16958,1249,0.06859998901521393
394,2023-01-01,8092,7562,530,0.06549678695007415
395,2023-01-02,18207,16992,1215,0.06673257538309442
396,2023-01-04,7441,6969,472,0.0634323343636608
397,2023-01-05,18207,16976,1231,0.06761135826879772
398,2023-01-08,8092,7551,541,0.06685615422639644
399,2023-01-09,20230,18859,1371,0.06777063766683143
400,2023-01-11,14161,13212,949,0.0670150413106419
401,2023-01-12,20250,18884,1366,0.06745679012345679
402,2023-01-15,14161,13243,918,0.06482593037214886
403,2023-01-16,30068,28013,2055,0.06834508447518957
404,2023-01-18,8092,7549,543,0.0671033119130005
405,2023-01-19,27868,25973,1895,0.06799913879718673
406,2023-01-22,8092,7544,548,0.06772120612951063
407,2023-01-23,24288,22625,1663,0.06847002635046114
408,2023-01-25,12138,11326,812,0.06689734717416378
409,2023-01-26,20870,19415,1455,0.0697172975563009
410,2023-01-29,10115,9390,725,0.07167572911517549
411,2023-01-30,20220,18825,1395,0.06899109792284866
412,2023-02-01,8092,7558,534,0.06599110232328226
413,2023-02-02,20610,19206,1404,0.06812227074235808
414,2023-02-05,8092,7483,609,0.07525951557093426
415,2023-02-06,20610,19018,1592,0.07724405628335759
416,2023-02-08,12138,11339,799,0.06582633053221289
417,2023-02-09,19536,18200,1336,0.06838656838656838
418,2023-02-12,12138,11326,812,0.06689734717416378
419,2023-02-13,16480,15346,1134,0.06881067961165048
420,2023-02-15,18207,17016,1191,0.06541440105453947
421,2023-02-16,16480,15352,1128,0.06844660194174758
422,2023-02-19,22253,20790,1463,0.0657439446366782
423,2023-02-20,18540,17278,1262,0.06806903991370011
424,2023-02-22,21668,20263,1405,0.06484216355916558
425,2023-02-23,18540,17266,1274,0.06871628910463862
426,2023-02-26,22253,20753,1500,0.06740664180110546
427,2023-02-27,16906,15769,1137,0.0672542292677156
428,2023-03-01,20230,19047,1183,0.05847750865051903
429,2023-03-02,14702,13751,951,0.06468507686029111
430,2023-03-03,3838,3462,376,0.0979676915059927
431,2023-03-05,22253,20826,1427,0.06412618523345166
432,2023-03-06,16611,15457,1154,0.06947203660225151
433,2023-03-08,20469,19114,1355,0.06619766476134642
434,2023-03-09,18523,17223,1300,0.07018301571019814
435,2023-03-12,20230,18722,1508,0.0745427582797825
436,2023-03-13,17571,16349,1222,0.0695464117010984
437,2023-03-15,17202,15855,1347,0.07830484827345657
438,2023-03-16,19332,17893,1439,0.074436168011587
439,2023-03-19,22237,20663,1574,0.07078292935198094
440,2023-03-20,18504,17122,1382,0.07468655425853869
441,2023-03-22,17420,16178,1242,0.07129735935706084
442,2023-03-23,20600,19081,1519,0.0737378640776699
443,2023-03-26,18193,16956,1237,0.0679931841917221
444,2023-03-27,16657,15429,1228,0.07372275920033619
445,2023-03-29,20218,18788,1430,0.07072905331882481
446,2023-03-30,18540,17157,1383,0.07459546925566343
