,date,measurements,ok,anomalies,ratio
0,2021-01-04,42315,42106,209,0.004939146874630746
1,2021-01-07,42252,42025,227,0.005372526744296128
2,2021-01-11,38745,38546,199,0.005136146599561233
3,2021-01-14,40320,40114,206,0.005109126984126984
4,2021-01-18,42357,42162,195,0.004603725476308521
5,2021-01-21,42336,42138,198,0.00467687074829932
6,2021-01-25,40340,40138,202,0.005007436787307883
7,2021-01-28,42315,42106,209,0.004939146874630746
8,2021-02-01,38342,38087,255,0.0066506702832403106
9,2021-02-04,36022,35914,108,0.0029981677863527845
10,2021-02-08,42294,41977,317,0.007495152976781576
11,2021-02-11,40280,39931,349,0.008664349553128104
12,2021-02-15,28252,28021,231,0.00817641228939544
13,2021-02-18,30240,30225,15,0.000496031746031746
14,2021-02-22,38304,38092,212,0.005534670008354219
15,2021-02-25,10075,10073,2,0.00019851116625310174
16,2021-03-01,28224,28124,100,0.0035430839002267575
17,2021-03-18,28196,28196,0,0.0
18,2021-03-22,22176,22176,0,0.0
19,2021-03-25,22154,22154,0,0.0
20,2021-03-29,25064,25037,27,0.001077242259814874
21,2021-04-01,26195,26102,93,0.0035502958579881655
22,2021-04-05,18153,18153,0,0.0
23,2021-04-06,90,90,0,0.0
24,2021-04-08,18126,18126,0,0.0
25,2021-04-12,26182,26178,4,0.00015277671682835536
26,2021-04-15,14091,14085,6,0.0004258037044922291
27,2021-04-19,28196,28188,8,0.0002837281883955171
28,2021-04-22,28196,28172,24,0.0008511845651865513
29,2021-04-26,19304,19301,3,0.0001554082055532532
30,2021-04-29,23268,23268,0,0.0
31,2021-05-03,24569,24569,0,0.0
32,2021-05-06,24153,24153,0,0.0
33,2021-05-10,34683,34682,1,2.8832569270247672e-05
34,2021-05-13,35757,35755,2,5.5933104007606904e-05
35,2021-05-17,33634,33631,3,8.919545697805792e-05
36,2021-05-20,34267,34267,0,0.0
37,2021-05-23,22784,22781,3,0.00013167134831460674
38,2021-05-24,6572,6572,0,0.0
39,2021-05-26,22017,22003,14,0.0006358722805105146
40,2021-05-27,8055,8051,4,0.0004965859714463067
41,2021-06-03,8060,8047,13,0.0016129032258064516
42,2021-06-06,22165,22140,25,0.0011279043537108053
43,2021-06-07,6037,6025,12,0.0019877422560874605
44,2021-06-09,24168,24146,22,0.0009102946044356173
45,2021-06-10,8041,8026,15,0.00186543962193757
46,2021-06-13,24192,24191,1,4.1335978835978834e-05
47,2021-06-14,6048,6046,2,0.00033068783068783067
48,2021-06-16,24192,24176,16,0.0006613756613756613
49,2021-06-17,6048,6044,4,0.0006613756613756613
50,2021-06-20,24180,24178,2,8.271298593879239e-05
51,2021-06-21,6045,6044,1,0.00016542597187758478
52,2021-06-23,24192,24187,5,0.00020667989417989417
53,2021-06-24,7141,7126,15,0.002100546141996919
54,2021-06-27,24192,24187,5,0.00020667989417989417
55,2021-06-28,8064,8063,1,0.0001240079365079365
56,2021-06-30,24156,24152,4,0.00016559032952475575
57,2021-07-01,8052,8050,2,0.00024838549428713363
58,2021-07-04,24192,24037,155,0.00640707671957672
59,2021-07-05,6110,6091,19,0.003109656301145663
60,2021-07-07,24180,24158,22,0.0009098428453267163
61,2021-07-08,8060,8048,12,0.001488833746898263
62,2021-07-11,24156,24154,2,8.279516476237788e-05
63,2021-07-12,8052,8045,7,0.0008693492300049677
64,2021-07-14,24132,24125,7,0.00029007127465605835
65,2021-07-15,8044,8044,0,0.0
66,2021-07-18,24156,24154,2,8.279516476237788e-05
67,2021-07-19,8052,8042,10,0.0012419274714356682
68,2021-07-21,24156,24148,8,0.0003311806590495115
69,2021-07-22,8052,8045,7,0.0008693492300049677
70,2021-07-25,24180,24166,14,0.0005789909015715467
71,2021-07-26,8060,8054,6,0.0007444168734491315
72,2021-07-28,24168,24164,4,0.00016550810989738498
73,2021-07-29,8056,8055,1,0.00012413108242303873
74,2021-08-01,24192,24182,10,0.00041335978835978834
75,2021-08-02,8064,8061,3,0.0003720238095238095
76,2021-08-04,22154,22137,17,0.0007673557822515121
77,2021-08-05,8056,8046,10,0.0012413108242303873
78,2021-08-08,24192,24185,7,0.00028935185185185184
79,2021-08-09,8064,8059,5,0.0006200396825396825
80,2021-08-11,24216,24213,3,0.0001238850346878097
81,2021-08-12,8072,8067,5,0.0006194251734390486
82,2021-08-15,24216,24214,2,8.259002312520647e-05
83,2021-08-16,8072,8071,1,0.0001238850346878097
84,2021-08-19,32224,32215,9,0.00027929493545183717
85,2021-08-22,24216,24211,5,0.0002064750578130162
86,2021-08-23,8072,8064,8,0.0009910802775024777
87,2021-08-25,24204,24184,20,0.0008263097008758883
88,2021-08-26,8068,8061,7,0.0008676251859196827
89,2021-08-29,24216,24209,7,0.0002890650809382227
90,2021-08-30,8072,8072,0,0.0
91,2021-09-02,8064,8060,4,0.000496031746031746
92,2021-09-05,24204,24190,14,0.0005784167906131218
93,2021-09-06,8068,8067,1,0.00012394645513138323
94,2021-09-08,24144,24106,38,0.0015738899933730947
95,2021-09-09,8048,8039,9,0.0011182902584493041
96,2021-09-12,24168,24146,22,0.0009102946044356173
97,2021-09-13,8056,8056,0,0.0
98,2021-09-15,20168,20142,26,0.001289170963903213
99,2021-09-16,8060,8056,4,0.0004962779156327543
100,2021-09-19,24192,23810,382,0.015790343915343917
101,2021-09-20,8064,8052,12,0.001488095238095238
102,2021-09-22,24180,24109,71,0.00293631100082713
103,2021-09-23,8060,8060,0,0.0
104,2021-09-26,24204,24200,4,0.00016526194017517766
105,2021-09-27,8068,8068,0,0.0
106,2021-09-29,24192,24189,3,0.0001240079365079365
107,2021-09-30,8064,8061,3,0.0003720238095238095
108,2021-10-03,24204,24203,1,4.1315485043794416e-05
109,2021-10-04,8068,8066,2,0.00024789291026276647
110,2021-10-06,24180,24178,2,8.271298593879239e-05
111,2021-10-07,8060,8060,0,0.0
112,2021-10-10,22187,22168,19,0.0008563573263622842
113,2021-10-11,8068,8068,0,0.0
114,2021-10-13,24192,24152,40,0.0016534391534391533
115,2021-10-14,8064,8061,3,0.0003720238095238095
116,2021-10-17,24228,24225,3,0.00012382367508667657
117,2021-10-18,8076,7971,105,0.01300148588410104
118,2021-10-20,24180,24165,15,0.0006203473945409429
119,2021-10-21,8060,8056,4,0.0004962779156327543
120,2021-10-24,24204,24202,2,8.263097008758883e-05
121,2021-10-25,8068,8068,0,0.0
122,2021-10-27,22187,22084,103,0.0046423581376481724
123,2021-10-28,8068,8064,4,0.0004957858205255329
124,2021-10-31,22198,22196,2,9.009820704567979e-05
125,2021-11-01,8072,8072,0,0.0
126,2021-11-03,22165,22160,5,0.00022558087074216106
127,2021-11-04,8060,8052,8,0.0009925558312655087
128,2021-11-07,22132,22131,1,4.518344478583047e-05
129,2021-11-08,8048,8040,8,0.0009940357852882703
130,2021-11-10,22165,22159,6,0.0002706970448905933
131,2021-11-14,22154,22152,2,9.027715085311908e-05
132,2021-11-17,22165,22160,5,0.00022558087074216106
133,2021-11-21,22165,22162,3,0.00013534852244529664
134,2021-11-24,20150,20147,3,0.0001488833746898263
135,2021-12-02,30236,30234,2,6.614631565021828e-05
136,2021-12-05,20150,20149,1,4.9627791563275434e-05
137,2021-12-06,8060,8059,1,0.00012406947890818859
138,2021-12-08,20120,20113,7,0.00034791252485089465
139,2021-12-09,8048,8046,2,0.00024850894632206757
140,2021-12-12,20140,20137,3,0.00014895729890764648
141,2021-12-13,8056,8055,1,0.00012413108242303873
142,2021-12-15,18135,18079,56,0.0030879514750482492
143,2021-12-16,8060,8057,3,0.00037220843672456576
144,2021-12-19,18126,18124,2,0.00011033873993158998
145,2021-12-20,8056,8056,0,0.0
146,2021-12-22,18126,18115,11,0.0006068630696237449
147,2021-12-23,8056,8055,1,0.00012413108242303873
148,2021-12-26,18135,18133,2,0.00011028398125172319
149,2021-12-27,8060,8059,1,0.00012406947890818859
150,2021-12-29,18108,18105,3,0.0001656726308813784
151,2021-12-30,8048,8037,11,0.0013667992047713719
152,2022-01-02,18126,18124,2,0.00011033873993158998
153,2022-01-03,8056,8054,2,0.00024826216484607745
154,2022-01-05,18117,18106,11,0.0006071645415907711
155,2022-01-06,8052,8027,25,0.0031048186785891706
156,2022-01-09,18135,18126,9,0.0004962779156327543
157,2022-01-10,8060,8056,4,0.0004962779156327543
158,2022-01-12,18135,18132,3,0.00016542597187758478
159,2022-01-13,7886,7875,11,0.001394876997210246
160,2022-01-16,18144,18143,1,5.511463844797178e-05
161,2022-01-17,8064,8051,13,0.0016121031746031745
162,2022-01-19,18135,18132,3,0.00016542597187758478
163,2022-01-20,8060,8053,7,0.0008684863523573201
164,2022-01-23,18135,18075,60,0.0033085194375516956
165,2022-01-24,8060,8055,5,0.0006203473945409429
166,2022-01-26,18144,18142,2,0.00011022927689594356
167,2022-01-27,6048,6045,3,0.000496031746031746
168,2022-01-30,18153,18151,2,0.00011017462678345177
169,2022-01-31,8068,8068,0,0.0
170,2022-02-02,18117,18109,8,0.0004415742120660153
171,2022-02-03,8052,8045,7,0.0008693492300049677
172,2022-02-06,18171,18168,3,0.0001650982334489021
173,2022-02-07,8076,8076,0,0.0
174,2022-02-09,18135,18122,13,0.0007168458781362007
175,2022-02-10,8060,8059,1,0.00012406947890818859
176,2022-02-13,18126,18123,3,0.00016550810989738498
177,2022-02-14,8056,8053,3,0.0003723932472691162
178,2022-02-16,18144,18142,2,0.00011022927689594356
179,2022-02-17,4718,4707,11,0.0023314963967782957
180,2022-02-18,1911,1911,0,0.0
181,2022-02-20,18162,18160,2,0.00011012003083360864
182,2022-02-21,8072,8072,0,0.0
183,2022-02-23,18162,18157,5,0.0002753000770840216
184,2022-02-24,8072,8072,0,0.0
185,2022-02-27,18162,18158,4,0.00022024006166721728
186,2022-02-28,8072,8072,0,0.0
187,2022-03-02,18108,18107,1,5.52242102937928e-05
188,2022-03-03,8048,8036,12,0.0014910536779324055
189,2022-03-06,14091,14084,7,0.0004967709885742673
190,2022-03-07,8052,8052,0,0.0
191,2022-03-09,18126,18111,15,0.0008275405494869249
192,2022-03-10,8056,8055,1,0.00012413108242303873
193,2022-03-13,18162,18160,2,0.00011012003083360864
194,2022-03-14,8072,8070,2,0.0002477700693756194
195,2022-03-16,18126,18125,1,5.516936996579499e-05
196,2022-03-17,8056,8051,5,0.0006206554121151937
197,2022-03-20,18135,18131,4,0.00022056796250344637
198,2022-03-21,8060,8060,0,0.0
199,2022-03-23,18126,18117,9,0.0004965243296921549
200,2022-03-24,8056,8052,4,0.0004965243296921549
201,2022-03-27,18135,18134,1,5.5141990625861594e-05
202,2022-03-28,8060,8058,2,0.00024813895781637717
203,2022-03-30,18135,18127,8,0.00044113592500689275
204,2022-03-31,8060,8059,1,0.00012406947890818859
205,2022-04-03,18126,18124,2,0.00011033873993158998
206,2022-04-04,8056,8055,1,0.00012413108242303873
207,2022-04-06,18108,18103,5,0.000276121051468964
208,2022-04-07,8048,8046,2,0.00024850894632206757
209,2022-04-10,18126,18124,2,0.00011033873993158998
210,2022-04-11,8056,8056,0,0.0
211,2022-04-13,18117,18072,45,0.0024838549428713363
212,2022-04-14,8052,8052,0,0.0
213,2022-04-17,18144,18141,3,0.00016534391534391533
214,2022-04-18,8064,8064,0,0.0
215,2022-04-20,18117,18115,2,0.00011039355301650383
216,2022-04-21,8052,8048,4,0.0004967709885742673
217,2022-04-25,10070,10070,0,0.0
218,2022-04-27,8044,8015,29,0.0036051715564395822
219,2022-04-28,4217,4206,11,0.002608489447474508
220,2022-04-29,2406,2404,2,0.0008312551953449709
221,2022-05-01,18126,18123,3,0.00016550810989738498
222,2022-05-02,8056,8056,0,0.0
223,2022-05-04,18135,18131,4,0.00022056796250344637
224,2022-05-05,8060,8038,22,0.002729528535980149
225,2022-05-08,8056,8023,33,0.004096325719960278
226,2022-05-09,12084,12084,0,0.0
227,2022-05-11,8040,8000,40,0.004975124378109453
228,2022-05-12,12060,12059,1,8.291873963515754e-05
229,2022-05-15,8020,8001,19,0.002369077306733167
230,2022-05-16,12030,12026,4,0.00033250207813798836
231,2022-05-18,8012,7976,36,0.0044932601098352475
232,2022-05-19,12018,12018,0,0.0
233,2022-05-22,8012,7980,32,0.00399400898652022
234,2022-05-23,12018,12013,5,0.0004160426027625229
235,2022-05-25,8012,7982,30,0.0037443834248627058
236,2022-05-26,12018,12017,1,8.320852055250458e-05
237,2022-05-29,8012,7972,40,0.004992511233150275
238,2022-05-30,12018,12018,0,0.0
239,2022-06-01,14021,13982,39,0.002781541972755153
240,2022-06-02,12018,12015,3,0.00024962556165751375
241,2022-06-05,14021,13974,47,0.0033521146851151844
242,2022-06-06,12018,12014,4,0.0003328340822100183
243,2022-06-08,14021,13985,36,0.0025675772056201413
244,2022-06-09,11115,11104,11,0.0009896536212325687
245,2022-06-12,12006,11972,34,0.00283191737464601
246,2022-06-13,10005,10005,0,0.0
247,2022-06-15,12018,11989,29,0.0024130470960226327
248,2022-06-16,10015,10015,0,0.0
249,2022-06-19,12012,11974,38,0.0031635031635031635
250,2022-06-20,10010,10010,0,0.0
251,2022-06-22,12012,11983,29,0.0024142524142524145
252,2022-06-23,10010,10010,0,0.0
253,2022-06-26,12102,12061,41,0.003387869773591142
254,2022-06-27,10085,10084,1,9.915716410510659e-05
255,2022-06-29,12102,12075,27,0.0022310361923648984
256,2022-06-30,10085,10082,3,0.0002974714923153198
257,2022-07-03,12102,12076,26,0.0021484052222773093
258,2022-07-04,10085,10077,8,0.0007932573128408527
259,2022-07-06,12114,12089,25,0.0020637279181112763
260,2022-07-07,10095,10093,2,0.00019811788013868252
261,2022-07-10,8121,8098,23,0.002832163526659278
262,2022-07-11,10095,10095,0,0.0
263,2022-07-13,12114,12081,33,0.0027241208519068845
264,2022-07-14,10095,10095,0,0.0
265,2022-07-17,12114,12085,29,0.0023939243850090806
266,2022-07-18,10095,10094,1,9.905894006934126e-05
267,2022-07-20,12114,12081,33,0.0027241208519068845
268,2022-07-21,10095,10094,1,9.905894006934126e-05
269,2022-07-24,12114,12083,31,0.0025590226184579825
270,2022-07-25,10095,10095,0,0.0
271,2022-07-27,12114,12079,35,0.002889219085355787
272,2022-07-28,10095,10095,0,0.0
273,2022-07-31,12114,12075,39,0.0032194155522535907
274,2022-08-01,10095,10080,15,0.0014858841010401188
275,2022-08-03,12114,12088,26,0.0021462770348357274
276,2022-08-04,10095,10091,4,0.00039623576027736503
277,2022-08-07,12114,12084,30,0.0024764735017335313
278,2022-08-08,10095,10095,0,0.0
279,2022-08-10,12120,12061,59,0.004867986798679868
280,2022-08-11,8080,7959,121,0.014975247524752475
281,2022-08-14,12120,12045,75,0.006188118811881188
282,2022-08-15,10100,10097,3,0.000297029702970297
283,2022-08-17,12120,12091,29,0.0023927392739273926
284,2022-08-18,10100,10099,1,9.900990099009902e-05
285,2022-08-21,12120,12088,32,0.0026402640264026403
286,2022-08-22,10100,10092,8,0.0007920792079207921
287,2022-08-24,12120,12087,33,0.0027227722772277226
288,2022-08-25,10100,10094,6,0.000594059405940594
289,2022-08-28,14140,14086,54,0.003818953323903819
290,2022-08-29,10100,10100,0,0.0
291,2022-08-31,14140,14071,69,0.00487977369165488
292,2022-09-01,10100,10099,1,9.900990099009902e-05
293,2022-09-04,12937,12860,77,0.0059519208471825
294,2022-09-05,10110,10109,1,9.891196834817012e-05
295,2022-09-07,14154,14088,66,0.0046629927935565915
296,2022-09-08,10110,10110,0,0.0
297,2022-09-11,14154,14081,73,0.005157552635297442
298,2022-09-12,10110,10108,2,0.00019782393669634025
299,2022-09-14,12108,12027,81,0.006689791873141724
300,2022-09-15,10090,10089,1,9.910802775024777e-05
301,2022-09-18,14133,14073,60,0.004245383145828911
302,2022-09-19,10095,10093,2,0.00019811788013868252
303,2022-09-21,14126,14038,88,0.006229647458587003
304,2022-09-22,10090,10085,5,0.0004955401387512388
305,2022-09-25,14140,14091,49,0.0034653465346534654
306,2022-09-26,10100,10099,1,9.900990099009902e-05
307,2022-09-28,14133,14080,53,0.003750088445482205
308,2022-09-29,10095,10094,1,9.905894006934126e-05
309,2022-10-02,14126,14070,56,0.003964321110009911
310,2022-10-03,10090,10089,1,9.910802775024777e-05
311,2022-10-05,12108,12050,58,0.004790221341261975
312,2022-10-06,6054,5567,487,0.0804426825239511
313,2022-10-09,12108,12065,43,0.0035513709943838785
314,2022-10-10,10090,10090,0,0.0
315,2022-10-12,14126,14063,63,0.0044598612487611496
316,2022-10-13,10090,10090,0,0.0
317,2022-10-19,8072,8068,4,0.0004955401387512388
318,2022-10-20,10090,10089,1,9.910802775024777e-05
319,2022-10-23,8076,8076,0,0.0
320,2022-10-24,10095,10093,2,0.00019811788013868252
321,2022-10-26,8076,8070,6,0.0007429420505200594
322,2022-10-27,10095,10095,0,0.0
323,2022-10-30,8076,8076,0,0.0
324,2022-10-31,10095,10095,0,0.0
325,2022-11-02,8076,8075,1,0.00012382367508667657
326,2022-11-03,10095,10058,37,0.0036651807825656265
327,2022-11-06,6063,6063,0,0.0
328,2022-11-07,10105,10105,0,0.0
329,2022-11-09,6063,6058,5,0.0008246742536698004
330,2022-11-10,8084,8078,6,0.0007422068283028204
331,2022-11-13,6066,6066,0,0.0
332,2022-11-14,10110,10109,1,9.891196834817012e-05
333,2022-11-16,6063,6063,0,0.0
334,2022-11-17,10105,10104,1,9.896091044037604e-05
335,2022-11-20,6063,6061,2,0.00032986970146792015
336,2022-11-21,10105,10104,1,9.896091044037604e-05
337,2022-11-23,6066,6066,0,0.0
338,2022-11-24,10110,10109,1,9.891196834817012e-05
339,2022-11-27,6069,6069,0,0.0
340,2022-11-28,10115,10114,1,9.886307464162135e-05
341,2022-11-30,6063,6063,0,0.0
342,2022-12-01,10105,10104,1,9.896091044037604e-05
343,2022-12-04,6063,6063,0,0.0
344,2022-12-05,10105,10104,1,9.896091044037604e-05
345,2022-12-07,6063,6063,0,0.0
346,2022-12-08,10105,10100,5,0.0004948045522018803
347,2022-12-11,6066,6066,0,0.0
348,2022-12-12,10110,10108,2,0.00019782393669634025
349,2022-12-14,6063,6061,2,0.00032986970146792015
350,2022-12-15,10105,10102,3,0.00029688273132112816
351,2022-12-18,6066,6066,0,0.0
352,2022-12-19,10110,10109,1,9.891196834817012e-05
353,2022-12-21,6069,6069,0,0.0
354,2022-12-22,10115,10114,1,9.886307464162135e-05
355,2022-12-25,12144,12144,0,0.0
356,2022-12-26,10120,10119,1,9.881422924901186e-05
357,2022-12-28,6069,6069,0,0.0
358,2022-12-29,10115,10112,3,0.00029658922392486405
359,2023-01-01,8092,8092,0,0.0
360,2023-01-02,8092,8089,3,0.0003707365299060801
361,2023-01-04,8092,8092,0,0.0
362,2023-01-05,8092,8092,0,0.0
363,2023-01-08,8092,8092,0,0.0
364,2023-01-09,10115,10114,1,9.886307464162135e-05
365,2023-01-11,2023,2023,0,0.0
366,2023-01-12,10125,10122,3,0.0002962962962962963
367,2023-01-15,2023,2023,0,0.0
368,2023-01-16,12138,12138,0,0.0
369,2023-01-18,2023,2023,0,0.0
370,2023-01-19,10183,10164,19,0.0018658548561327703
371,2023-01-22,2023,2022,1,0.0004943153732081067
372,2023-01-23,12144,12142,2,0.00016469038208168644
373,2023-01-25,4046,4046,0,0.0
374,2023-01-26,12138,12118,20,0.0016477179106936892
375,2023-01-29,2023,2022,1,0.0004943153732081067
376,2023-01-30,8088,8041,47,0.005811078140454995
377,2023-02-01,6069,6067,2,0.00032954358213873783
378,2023-02-02,8244,8241,3,0.000363901018922853
379,2023-02-05,6069,6068,1,0.00016477179106936892
380,2023-02-06,10305,10298,7,0.0006792819019893256
381,2023-02-09,8244,8242,2,0.00024260067928190198
382,2023-02-12,2023,2021,2,0.0009886307464162135
383,2023-02-13,6180,6178,2,0.00032362459546925567
384,2023-02-15,4046,4045,1,0.00024715768660405336
385,2023-02-16,6180,6175,5,0.0008090614886731392
386,2023-02-20,6180,6176,4,0.0006472491909385113
387,2023-02-22,6069,6054,15,0.002471576866040534
388,2023-02-23,6180,6178,2,0.00032362459546925567
389,2023-02-26,4046,4041,5,0.001235788433020267
390,2023-02-27,6180,6177,3,0.0004854368932038835
391,2023-03-01,4046,4045,1,0.00024715768660405336
392,2023-03-02,5112,5112,0,0.0
393,2023-03-03,1068,1068,0,0.0
394,2023-03-05,6069,6067,2,0.00032954358213873783
395,2023-03-06,6180,6178,2,0.00032362459546925567
396,2023-03-08,4046,4044,2,0.0004943153732081067
397,2023-03-09,6180,6180,0,0.0
398,2023-03-12,4046,4046,0,0.0
399,2023-03-13,6180,6177,3,0.0004854368932038835
400,2023-03-15,4046,4045,1,0.00024715768660405336
401,2023-03-16,6180,6180,0,0.0
402,2023-03-19,4046,4042,4,0.0009886307464162135
403,2023-03-20,6180,6180,0,0.0
404,2023-03-22,4046,4046,0,0.0
405,2023-03-23,8240,8237,3,0.00036407766990291263
406,2023-03-26,4046,4043,3,0.0007414730598121602
407,2023-03-27,6180,6180,0,0.0
408,2023-03-29,4046,4042,4,0.0009886307464162135
409,2023-03-30,6180,6177,3,0.0004854368932038835
