,date,measurements,ok,anomalies,ratio
0,2021-01-03,3936,3758,178,0.04522357723577236
1,2021-01-04,494206,493431,775,0.0015681719768679458
2,2021-01-06,3936,3758,178,0.04522357723577236
3,2021-01-07,452133,451319,814,0.0018003552052161642
4,2021-01-10,3936,3756,180,0.04573170731707317
5,2021-01-11,474199,473398,801,0.0016891642538259255
6,2021-01-13,3936,3757,179,0.045477642276422765
7,2021-01-14,462198,461381,817,0.0017676407080947992
8,2021-01-17,3936,3758,178,0.04522357723577236
9,2021-01-18,481663,480846,817,0.0016962066839263136
10,2021-01-20,3936,3757,179,0.045477642276422765
11,2021-01-21,479005,478147,858,0.001791213035354537
12,2021-01-24,5904,5726,178,0.030149051490514906
13,2021-01-25,472731,471979,752,0.0015907566882645734
14,2021-01-27,5904,5726,178,0.030149051490514906
15,2021-01-28,434261,433484,777,0.0017892465590969486
16,2021-01-31,3936,3758,178,0.04522357723577236
17,2021-02-01,420223,419368,855,0.0020346339919518923
18,2021-02-03,3544,3387,157,0.04430022573363431
19,2021-02-04,475728,474835,893,0.0018771230619177345
20,2021-02-07,5904,5633,271,0.04590108401084011
21,2021-02-08,466916,466132,784,0.0016791028793187639
22,2021-02-10,5904,5633,271,0.04590108401084011
23,2021-02-11,443864,443073,791,0.0017820773930753565
24,2021-02-14,5904,5636,268,0.04539295392953929
25,2021-02-15,461104,460354,750,0.0016265311079496165
26,2021-02-17,5904,5639,265,0.044884823848238484
27,2021-02-18,455195,454375,820,0.0018014257625852657
28,2021-02-21,7872,7603,269,0.034171747967479675
29,2021-02-22,449699,448916,783,0.001741164645685225
30,2021-02-24,7872,7600,272,0.034552845528455285
31,2021-02-25,429257,428471,786,0.0018310708969218907
32,2021-02-28,5904,5635,269,0.04556233062330623
33,2021-03-01,473943,473045,898,0.001894742616728172
34,2021-03-17,2014,2011,3,0.0014895729890764648
35,2021-03-18,462307,461021,1286,0.002781701336990355
36,2021-03-21,10080,9598,482,0.047817460317460314
37,2021-03-22,461845,461023,822,0.0017798179042752438
38,2021-03-24,10070,9589,481,0.0477656405163853
39,2021-03-25,433489,432605,884,0.0020392674323915947
40,2021-03-28,10070,9574,496,0.04925521350546177
41,2021-03-29,462433,461659,774,0.0016737559819476552
42,2021-04-01,443954,443121,833,0.0018763205196934817
43,2021-04-04,10085,9584,501,0.049677739216658405
44,2021-04-05,471402,470539,863,0.0018307092460362918
45,2021-04-06,2329,2320,9,0.0038643194504079004
46,2021-04-07,10070,9569,501,0.04975173783515392
47,2021-04-08,440080,439188,892,0.0020269041992365022
48,2021-04-11,10070,9599,471,0.04677259185700099
49,2021-04-12,473411,472454,957,0.0020214992892011382
50,2021-04-14,10065,9595,470,0.04669647292598112
51,2021-04-15,443214,442256,958,0.002161484068644041
52,2021-04-18,12084,11488,596,0.04932141674942072
53,2021-04-19,465199,464218,981,0.0021087749543743646
54,2021-04-21,12084,11496,588,0.04865938430983118
55,2021-04-22,467309,466433,876,0.0018745626555448321
56,2021-04-25,12102,11522,580,0.04792596265080152
57,2021-04-26,458735,457976,759,0.0016545500125344698
58,2021-04-28,12072,11530,542,0.04489728296885354
59,2021-04-29,467157,466393,764,0.001635424493264577
60,2021-05-02,12078,11514,564,0.04669647292598112
61,2021-05-03,477103,476146,957,0.0020058561778064695
62,2021-05-05,12096,11545,551,0.04555224867724868
63,2021-05-06,472185,471257,928,0.0019653313849444603
64,2021-05-09,16128,15375,753,0.046688988095238096
65,2021-05-10,473802,472939,863,0.0018214359584805468
66,2021-05-12,16104,15408,696,0.043219076005961254
67,2021-05-13,475419,474580,839,0.0017647590861955454
68,2021-05-17,488893,487206,1687,0.0034506528013287163
69,2021-05-20,475931,474361,1570,0.003298797514765796
70,2021-05-23,260634,259809,825,0.003165358318561661
71,2021-05-24,225674,224865,809,0.0035848170369648254
72,2021-05-26,256242,255463,779,0.0030400949102801257
73,2021-05-27,224224,223403,821,0.0036615170543741974
74,2021-05-30,76492,72896,3596,0.04701145217800554
75,2021-06-03,224067,223223,844,0.0037667304868633043
76,2021-06-06,261950,261128,822,0.003138003435770185
77,2021-06-07,222009,221156,853,0.003842186578021612
78,2021-06-09,261035,259903,1132,0.004336583216810006
79,2021-06-10,221698,220853,845,0.0038114913079955615
80,2021-06-13,257838,256980,858,0.003327670863100086
81,2021-06-14,222090,221243,847,0.0038137691926696383
82,2021-06-16,251484,250639,845,0.0033600547152105105
83,2021-06-17,219744,218944,800,0.0036405999708752
84,2021-06-20,253890,253035,855,0.00336760014179369
85,2021-06-21,219635,218799,836,0.0038063150226512166
86,2021-06-23,254016,253126,890,0.003503716301335349
87,2021-06-24,217728,216850,878,0.004032554379776602
88,2021-06-27,254006,253123,883,0.0034762958355314443
89,2021-06-28,215712,214871,841,0.0038987168075953122
90,2021-06-30,251625,250806,819,0.003254843517138599
91,2021-07-01,213443,212632,811,0.0037996092633630525
92,2021-07-04,252000,251143,857,0.003400793650793651
93,2021-07-05,213696,212822,874,0.004089922132374963
94,2021-07-07,249860,249029,831,0.0033258624829904746
95,2021-07-08,213590,212738,852,0.003988950793576479
96,2021-07-11,243593,242715,878,0.0036043728678574506
97,2021-07-12,213378,212556,822,0.0038523184208306385
98,2021-07-14,245342,244525,817,0.0033300454060046793
99,2021-07-15,211155,210329,826,0.003911818332504559
100,2021-07-18,241560,240697,863,0.0035726113594966055
101,2021-07-19,213378,212544,834,0.003908556645952254
102,2021-07-21,243573,242740,833,0.0034199192849782203
103,2021-07-22,213378,212552,826,0.003871064495871177
104,2021-07-25,241800,240946,854,0.0035318444995864353
105,2021-07-26,212817,211987,830,0.0039000643745565437
106,2021-07-28,243694,242846,848,0.0034797738147020443
107,2021-07-29,207442,206631,811,0.003909526518255705
108,2021-08-01,233856,233498,358,0.0015308565955117679
109,2021-08-02,207648,207102,546,0.0026294498381877023
110,2021-08-04,233624,233237,387,0.0016565078930246893
111,2021-08-05,205428,204861,567,0.0027600911268181555
112,2021-08-08,230069,229657,412,0.0017907671176907796
113,2021-08-09,207648,207075,573,0.0027594775774387424
114,2021-08-11,235050,234639,411,0.0017485641352903637
115,2021-08-12,203846,203260,586,0.0028747191507314347
116,2021-08-15,234088,233688,400,0.001708759099142203
117,2021-08-16,207854,207308,546,0.0026268438423123924
118,2021-08-19,439052,438075,977,0.002225248945455208
119,2021-08-22,228405,227986,419,0.001834460716709354
120,2021-08-23,207854,207310,544,0.0026172217036958636
121,2021-08-25,231955,231528,427,0.001840874307516544
122,2021-08-26,207751,207041,710,0.003417552743428431
123,2021-08-29,230052,229563,489,0.002125606384643472
124,2021-08-30,207854,207236,618,0.002973240832507433
125,2021-09-02,205605,205031,574,0.0027917609007563045
126,2021-09-05,229938,229548,390,0.0016961093860084022
127,2021-09-06,205734,205187,547,0.0026587729787006524
128,2021-09-08,227356,226997,359,0.001579021446541987
129,2021-09-09,205224,204687,537,0.002616653023038241
130,2021-09-12,227582,227227,355,0.0015598773189443806
131,2021-09-13,205428,204852,576,0.00280390209708511
132,2021-09-15,223665,223305,360,0.0016095499966467708
133,2021-09-16,199631,199057,574,0.0028753049376098903
134,2021-09-19,221760,221396,364,0.0016414141414141414
135,2021-09-20,205632,205093,539,0.0026211873638344227
136,2021-09-22,221650,221290,360,0.0016241822693435597
137,2021-09-23,204615,204043,572,0.002795493976492437
138,2021-09-26,218207,217820,387,0.0017735453033129094
139,2021-09-27,203717,203159,558,0.0027390939391410633
140,2021-09-29,218520,218104,416,0.0019037159070107999
141,2021-09-30,203616,203077,539,0.002647139713971397
142,2021-10-03,219853,219472,381,0.0017329761249562207
143,2021-10-04,202533,201948,585,0.0028884181837033965
144,2021-10-06,215605,215205,400,0.0018552445444215116
145,2021-10-07,201500,200913,587,0.002913151364764268
146,2021-10-10,217836,217452,384,0.0017627940285352283
147,2021-10-11,198914,198356,558,0.0028052324119971447
148,2021-10-13,215712,214545,1167,0.005409991099243436
149,2021-10-14,183852,183158,694,0.0037747753627918107
150,2021-10-17,218052,217647,405,0.0018573551263001485
151,2021-10-18,195843,195296,547,0.0027930536194809108
152,2021-10-20,217620,217227,393,0.0018059001929969672
153,2021-10-21,191794,191250,544,0.0028363765289842226
154,2021-10-24,213802,213369,433,0.002025238304599583
155,2021-10-25,191615,191072,543,0.0028338073741617305
156,2021-10-27,216774,216320,454,0.002094347108048013
157,2021-10-28,191553,190932,621,0.0032419226010555824
158,2021-10-31,209872,209449,423,0.0020155142181901347
159,2021-11-01,187674,187136,538,0.002866673060732973
160,2021-11-03,207545,207184,361,0.0017393818208099449
161,2021-11-04,187395,186851,544,0.0029029589903679393
162,2021-11-07,209248,208875,373,0.0017825737880409849
163,2021-11-08,184882,184279,603,0.0032615397929490163
164,2021-11-10,208465,208082,383,0.0018372388650372965
165,2021-11-14,213484,213116,368,0.0017237825785538963
166,2021-11-17,211575,211164,411,0.0019425735554767813
167,2021-11-21,215605,215267,338,0.0015676816400361773
168,2021-11-24,213590,213180,410,0.0019195655227304648
169,2021-12-02,395045,393925,1120,0.002835120049614601
170,2021-12-05,211575,211255,320,0.0015124660285950609
171,2021-12-06,183365,182836,529,0.002884956234832165
172,2021-12-08,209248,208920,328,0.0015675179691084264
173,2021-12-09,181080,180550,530,0.0029268831455710183
174,2021-12-12,207442,207097,345,0.001663115473240713
175,2021-12-13,181260,180715,545,0.003006730663135827
176,2021-12-15,204704,204130,574,0.0028040487728622793
177,2021-12-16,137020,136654,366,0.0026711428988468837
178,2021-12-19,203414,203076,338,0.0016616358756034492
179,2021-12-20,136952,136572,380,0.002774694783573807
180,2021-12-22,203414,203079,335,0.0016468876281868505
181,2021-12-23,138966,138608,358,0.002576169710576688
182,2021-12-26,203515,203186,329,0.0016165884578532295
183,2021-12-27,139035,138653,382,0.0027475096198798865
184,2021-12-29,203212,202891,321,0.001579631124146212
185,2021-12-30,138828,138463,365,0.002629152620508831
186,2022-01-02,203414,203095,319,0.0015682303086316577
187,2022-01-03,138966,138608,358,0.002576169710576688
188,2022-01-05,203313,202995,318,0.0015640908353130394
189,2022-01-06,138897,138531,366,0.002635046113306983
190,2022-01-09,201500,201165,335,0.001662531017369727
191,2022-01-10,136240,135864,376,0.002759835584263065
192,2022-01-12,203515,203169,346,0.0017001203842468614
193,2022-01-13,135873,135499,374,0.0027525704150199084
194,2022-01-16,203616,203281,335,0.0016452538110953952
195,2022-01-17,135844,135485,359,0.0026427372574423604
196,2022-01-19,203515,203161,354,0.0017394295260791588
197,2022-01-20,135005,134649,356,0.002636939372615829
198,2022-01-23,201500,201160,340,0.0016873449131513648
199,2022-01-24,130975,130739,236,0.0018018705859896927
200,2022-01-26,203616,203267,349,0.001714010686782964
201,2022-01-27,129894,129643,251,0.0019323448350193236
202,2022-01-30,198364,198016,348,0.0017543505878082717
203,2022-01-31,135139,134899,240,0.0017759492078526554
204,2022-02-02,201300,200938,362,0.0017983109786388475
205,2022-02-03,134871,134632,239,0.001772063675660446
206,2022-02-06,201900,201556,344,0.0017038137691926696
207,2022-02-07,133627,133378,249,0.0018633958705950144
208,2022-02-09,203515,203161,354,0.0017394295260791588
209,2022-02-10,133107,132865,242,0.0018180862013267522
210,2022-02-13,203414,203067,347,0.001705880617853245
211,2022-02-14,134938,134699,239,0.0017711838029317167
212,2022-02-16,201600,201230,370,0.0018353174603174603
213,2022-02-17,90846,90707,139,0.0015300618629328754
214,2022-02-18,42210,42118,92,0.002179578298981284
215,2022-02-20,203818,203469,349,0.001712311964595865
216,2022-02-21,133525,133250,275,0.0020595394120951132
217,2022-02-23,203818,203465,353,0.001731937316625617
218,2022-02-24,135206,134951,255,0.0018860109758442672
219,2022-02-27,203818,203427,391,0.0019183781609082612
220,2022-02-28,133922,133657,265,0.0019787637580083927
221,2022-03-02,203212,202781,431,0.00212093773989725
222,2022-03-03,134804,134458,346,0.00256668941574434
223,2022-03-06,203313,202915,398,0.001957572806460974
224,2022-03-07,134871,134616,255,0.0018906955535289277
225,2022-03-09,203414,203009,405,0.001991013401240819
226,2022-03-10,133179,132897,282,0.0021174509494740162
227,2022-03-13,203818,203415,403,0.0019772542169975175
228,2022-03-14,131170,130895,275,0.002096515971639857
229,2022-03-16,203414,202994,420,0.0020647546383238125
230,2022-03-17,129288,129027,261,0.002018748839799517
231,2022-03-20,203515,203127,388,0.0019064933788664226
232,2022-03-21,130975,130704,271,0.002069097155945791
233,2022-03-23,203414,203016,398,0.0019566008239354222
234,2022-03-24,130910,130652,258,0.0019708196470857842
235,2022-03-27,203055,202661,394,0.00194036098593977
236,2022-03-28,128960,128708,252,0.0019540942928039703
237,2022-03-30,201500,201116,384,0.0019057071960297766
238,2022-03-31,132990,132712,278,0.002090382735544026
239,2022-04-03,203414,203033,381,0.00187302742190803
240,2022-04-04,131627,131364,263,0.0019980703047247144
241,2022-04-06,203212,202821,391,0.0019240989705332362
242,2022-04-07,130911,130643,268,0.002047192367333532
243,2022-04-10,203414,203026,388,0.0019074399992134268
244,2022-04-11,129803,129522,281,0.002164818994938484
245,2022-04-13,203313,202921,392,0.0019280616586248788
246,2022-04-14,129712,129395,317,0.002443875663007278
247,2022-04-17,201600,201208,392,0.0019444444444444444
248,2022-04-18,129024,128748,276,0.002139136904761905
249,2022-04-20,201300,200898,402,0.0019970193740685544
250,2022-04-21,128065,127784,281,0.0021941982586967555
251,2022-04-24,66462,65666,796,0.01197676867984713
252,2022-04-25,52364,52257,107,0.0020433885875792528
253,2022-04-27,58319,57643,676,0.011591419605960322
254,2022-04-28,77139,76991,148,0.0019186144492409805
255,2022-04-29,51565,51444,121,0.00234655289440512
256,2022-05-01,201400,201017,383,0.0019016881827209533
257,2022-05-02,128102,127774,328,0.002560459633729372
258,2022-05-04,195436,195016,420,0.002149041118320064
259,2022-05-05,125560,125260,300,0.002389295954125518
260,2022-05-08,114798,113981,817,0.007116848725587554
261,2022-05-09,58406,58140,266,0.004554326610279766
262,2022-05-11,114570,113757,813,0.007096098455092956
263,2022-05-12,58290,58024,266,0.004563389946817636
264,2022-05-15,114285,113383,902,0.007892549328433304
265,2022-05-16,58145,57854,291,0.0050047295554217905
266,2022-05-18,112729,111872,857,0.0076023028679399265
267,2022-05-19,58087,57813,274,0.0047170623375281905
268,2022-05-22,114171,113310,861,0.007541319599548046
269,2022-05-23,58087,57787,300,0.005164666792914077
270,2022-05-25,114171,113314,857,0.007506284432999623
271,2022-05-26,58087,57815,272,0.00468263122557543
272,2022-05-29,114171,113289,882,0.007725254223927267
273,2022-05-30,62093,62048,45,0.0007247193725540721
274,2022-06-01,96144,95371,773,0.008040023298385754
275,2022-06-02,62093,62047,46,0.0007408242474997182
276,2022-06-05,98147,97359,788,0.008028773166780441
277,2022-06-06,62093,62047,46,0.0007408242474997182
278,2022-06-08,98147,97379,768,0.00782499719808043
279,2022-06-09,60090,60034,56,0.0009319354301880513
280,2022-06-12,98049,97265,784,0.0079960019990005
281,2022-06-13,62031,61972,59,0.0009511373345585272
282,2022-06-15,98147,97373,774,0.007886129988690434
283,2022-06-16,62093,62048,45,0.0007247193725540721
284,2022-06-19,98098,97312,786,0.008012395767497809
285,2022-06-20,60060,60018,42,0.0006993006993006993
286,2022-06-22,98098,97327,771,0.007859487451324186
287,2022-06-23,58058,58015,43,0.0007406386716731544
288,2022-06-26,98833,98044,789,0.007983163518258072
289,2022-06-27,58493,58450,43,0.0007351306993999282
290,2022-06-29,98833,98062,771,0.007801038114799713
291,2022-06-30,50425,50382,43,0.0008527516113039167
292,2022-07-03,98833,98059,774,0.00783139234870944
293,2022-07-04,56476,56415,61,0.0010801048232877682
294,2022-07-06,98931,98177,754,0.007621473552273807
295,2022-07-07,60570,60526,44,0.0007264322271751692
296,2022-07-10,65851,65477,374,0.0056794885423152265
297,2022-07-11,60570,60506,64,0.0010566286940729734
298,2022-07-13,98931,98221,710,0.007176719127472683
299,2022-07-14,60570,60526,44,0.0007264322271751692
300,2022-07-17,98931,98193,738,0.007459744670527944
301,2022-07-18,60570,60523,47,0.0007759616972098398
302,2022-07-20,98931,98204,727,0.007348556064327663
303,2022-07-21,60570,60507,63,0.0010401188707280832
304,2022-07-24,98931,98195,736,0.007439528560309711
305,2022-07-25,60482,60420,62,0.0010250983763764425
306,2022-07-27,98931,98211,720,0.007277799678563847
307,2022-07-28,60570,60397,173,0.002856199438666006
308,2022-07-31,98931,98198,733,0.007409204394982361
309,2022-08-01,58551,58508,43,0.0007344024867209783
310,2022-08-03,98931,98196,735,0.007429420505200594
311,2022-08-04,58551,58507,44,0.0007514816143191406
312,2022-08-07,98931,98203,728,0.007358664119436779
313,2022-08-08,58551,58497,54,0.0009222728903007635
314,2022-08-10,98980,98270,710,0.007173166296221459
315,2022-08-11,60600,60552,48,0.0007920792079207921
316,2022-08-14,96960,96230,730,0.007528877887788779
317,2022-08-15,60600,60555,45,0.0007425742574257426
318,2022-08-17,98980,98266,714,0.0072135785007072135
319,2022-08-18,60600,60533,67,0.0011056105610561056
320,2022-08-21,98980,98239,741,0.007486360880986058
321,2022-08-22,60600,60544,56,0.0009240924092409241
322,2022-08-24,98980,98274,706,0.007132754091735704
323,2022-08-25,60600,60536,64,0.001056105610561056
324,2022-08-28,98980,98252,728,0.007355021216407355
325,2022-08-29,60600,60543,57,0.0009405940594059406
326,2022-08-31,98980,98245,735,0.007425742574257425
327,2022-09-01,58580,58527,53,0.000904745646978491
328,2022-09-04,99078,98331,747,0.007539514322049294
329,2022-09-05,60660,60616,44,0.0007253544345532477
330,2022-09-07,99078,98362,716,0.007226629524213246
331,2022-09-08,58638,58589,49,0.0008356355946655752
332,2022-09-11,99078,98318,760,0.007670724075980541
333,2022-09-12,58638,58592,46,0.0007844742317268665
334,2022-09-14,98882,98155,727,0.007352197568819401
335,2022-09-15,60540,60492,48,0.0007928642220019821
336,2022-09-18,98931,98170,761,0.0076922299380376225
337,2022-09-19,60570,60517,53,0.0008750206372791811
338,2022-09-21,98882,98172,710,0.00718027547986489
339,2022-09-22,60540,60484,56,0.0009250082590023125
340,2022-09-25,98980,98237,743,0.007506566983228935
341,2022-09-26,60600,60551,49,0.0008085808580858086
342,2022-09-28,98931,98219,712,0.007196935237690916
343,2022-09-29,60570,60526,44,0.0007264322271751692
344,2022-10-02,98882,98165,717,0.007251066928257923
345,2022-10-03,60540,60491,49,0.0008093822266270234
346,2022-10-05,98882,98185,697,0.007048805647134969
347,2022-10-06,60540,60496,44,0.0007267922035018169
348,2022-10-09,95825,95091,734,0.00765979650404383
349,2022-10-10,58522,58474,48,0.0008202043675882574
350,2022-10-12,96864,96164,700,0.007226627023455567
351,2022-10-13,56504,56503,1,1.769786209825853e-05
352,2022-10-19,113008,112080,928,0.008211808013591958
353,2022-10-20,56504,56500,4,7.079144839303412e-05
354,2022-10-23,113064,112150,914,0.008083917073515886
355,2022-10-24,56532,56528,4,7.075638576381519e-05
356,2022-10-26,113064,112159,905,0.008004316139531592
357,2022-10-27,56532,56527,5,8.844548220476898e-05
358,2022-10-30,113064,112095,969,0.008570367225642115
359,2022-10-31,56532,56530,2,3.5378192881907595e-05
360,2022-11-02,113064,112167,897,0.007933559753767777
361,2022-11-03,52149,51950,199,0.0038159888013192967
362,2022-11-06,113176,112246,930,0.008217289884781225
363,2022-11-07,54567,54566,1,1.8326094525995565e-05
364,2022-11-09,111155,110291,864,0.0077729296927713555
365,2022-11-10,54567,54559,8,0.00014660875620796452
366,2022-11-13,113232,112262,970,0.008566482973011163
367,2022-11-14,54594,54590,4,7.326812470234824e-05
368,2022-11-16,113176,112272,904,0.007987559199830352
369,2022-11-17,54567,54559,8,0.00014660875620796452
370,2022-11-20,111155,110176,979,0.00880752102919347
371,2022-11-21,54567,54566,1,1.8326094525995565e-05
372,2022-11-23,111210,110279,931,0.008371549321104217
373,2022-11-24,58638,58620,18,0.00030696817763225213
374,2022-11-27,103173,102384,789,0.007647349597278357
375,2022-11-28,58667,58664,3,5.11360730904938e-05
376,2022-11-30,113176,112157,1019,0.009003675690959214
377,2022-12-01,58609,58604,5,8.531112968997936e-05
378,2022-12-04,113176,112108,1068,0.009436629674135858
379,2022-12-05,58609,58606,3,5.118667781398761e-05
380,2022-12-07,111155,110261,894,0.008042823084881473
381,2022-12-08,58609,58605,4,6.824890375198349e-05
382,2022-12-11,112096,111051,1045,0.009322366542963175
383,2022-12-12,58638,58634,4,6.821515058494491e-05
384,2022-12-14,113176,112220,956,0.008447020569732098
385,2022-12-15,58609,58605,4,6.824890375198349e-05
386,2022-12-18,109188,108066,1122,0.01027585448950434
387,2022-12-19,58638,58634,4,6.821515058494491e-05
388,2022-12-21,109242,108100,1142,0.010453854744512185
389,2022-12-22,58667,58664,3,5.11360730904938e-05
390,2022-12-25,218592,216544,2048,0.009369052847313717
391,2022-12-26,58696,58692,4,6.814774430966335e-05
392,2022-12-28,107219,106312,907,0.008459321575467034
393,2022-12-29,58667,58666,1,1.7045357696831268e-05
394,2023-01-01,115311,114208,1103,0.009565436081553365
395,2023-01-02,58667,58085,582,0.009920398179555798
396,2023-01-04,115311,114230,1081,0.009374647691894096
397,2023-01-05,57442,57238,204,0.0035514083771456427
398,2023-01-08,115311,114191,1120,0.0097128634735628
399,2023-01-09,72828,72250,578,0.007936507936507936
400,2023-01-11,113288,112416,872,0.0076971965256690915
401,2023-01-12,72900,72268,632,0.008669410150891633
402,2023-01-15,113288,112482,806,0.007114610550102394
403,2023-01-16,84966,84427,539,0.006343713956170703
404,2023-01-18,101150,100509,641,0.006337123084527929
405,2023-01-19,85008,84467,541,0.006364106907585168
406,2023-01-22,101150,100481,669,0.006613939693524469
407,2023-01-23,66792,66687,105,0.0015720445562342796
408,2023-01-25,111265,110306,959,0.008619062598301353
409,2023-01-26,66759,66645,114,0.0017076349256280052
410,2023-01-29,111265,110002,1263,0.01135127847930616
411,2023-01-30,84924,84513,411,0.004839621308464039
412,2023-02-01,97104,96370,734,0.007558905915307299
413,2023-02-02,84501,84106,395,0.004674500893480551
414,2023-02-05,99127,98374,753,0.007596315837259273
415,2023-02-06,72135,71837,298,0.0041311429957718165
416,2023-02-08,103173,102282,891,0.00863598034369457
417,2023-02-09,72135,71826,309,0.004283634851320441
418,2023-02-12,105196,104235,961,0.00913532833948059
419,2023-02-13,70040,69641,399,0.005696744717304397
420,2023-02-15,93058,92203,855,0.009187818349846333
421,2023-02-16,70040,69643,397,0.005668189605939463
422,2023-02-19,10115,10112,3,0.00029658922392486405
423,2023-02-20,70040,69640,400,0.0057110222729868645
424,2023-02-22,93058,92226,832,0.008940660663242278
425,2023-02-23,72100,71700,400,0.005547850208044383
426,2023-02-26,95081,94176,905,0.009518200271347588
427,2023-02-27,71450,71028,422,0.005906228131560532
428,2023-03-01,95081,94249,832,0.008750433840620103
429,2023-03-02,59453,59101,352,0.005920643197147327
430,2023-03-03,12647,12589,58,0.0045860678421760104
431,2023-03-05,95081,94221,860,0.00904491959487174
432,2023-03-06,72100,71699,401,0.005561719833564494
433,2023-03-08,95081,94214,867,0.00911854103343465
434,2023-03-09,72100,71694,406,0.005631067961165049
435,2023-03-12,95081,94158,923,0.009707512541937927
436,2023-03-13,72100,71685,415,0.0057558945908460475
437,2023-03-15,95081,94143,938,0.009865272767429876
438,2023-03-16,72100,71696,404,0.005603328710124826
439,2023-03-19,93058,92063,995,0.010692256442218832
440,2023-03-20,72100,71695,405,0.0056171983356449375
441,2023-03-22,90060,89286,774,0.008594270486342438
442,2023-03-23,72100,71696,404,0.005603328710124826
443,2023-03-26,90338,89524,814,0.009010604618211605
444,2023-03-27,70040,69637,403,0.005753854940034266
445,2023-03-29,93058,92291,767,0.008242171548926477
446,2023-03-30,70762,70348,414,0.00585059777846867
