,date,measurements,ok,anomalies,ratio
0,2021-01-01,60139,59806,333,0.005537172217695671
1,2021-01-04,5019,4994,25,0.004981071926678621
2,2021-01-05,67521,67091,430,0.006368389093763422
3,2021-01-07,7574,7533,41,0.005413255875363085
4,2021-01-08,64858,64446,412,0.00635233895587283
5,2021-01-14,8012,7970,42,0.005242136794807789
6,2021-01-15,60532,60150,382,0.006310711689684795
7,2021-01-18,6662,6622,40,0.006004202942059442
8,2021-01-19,58717,58309,408,0.00694858388541649
9,2021-01-21,12370,12305,65,0.005254648342764754
10,2021-01-22,58190,57813,377,0.006478776422065647
11,2021-01-26,70077,69618,459,0.00654993792542489
12,2021-01-29,68511,68085,426,0.006217979594517669
13,2021-02-01,9335,9261,74,0.007927155865024103
14,2021-02-02,50045,49638,407,0.008132680587471276
15,2021-02-04,159,158,1,0.006289308176100629
16,2021-02-05,57912,57357,555,0.009583506009117282
17,2021-02-09,54378,53196,1182,0.021736731766523226
18,2021-02-12,64379,63770,609,0.009459606393389148
19,2021-02-15,9615,9559,56,0.005824232969318773
20,2021-02-16,42853,42528,325,0.0075840664597577765
21,2021-02-18,12207,12091,116,0.009502744327025477
22,2021-02-19,34726,34144,582,0.01675977653631285
23,2021-02-22,1535,1524,11,0.0071661237785016286
24,2021-02-23,3911,3907,4,0.0010227563283047815
25,2021-02-25,2913,2909,4,0.0013731548232063166
26,2021-02-26,26769,26496,273,0.010198363778998095
27,2021-03-01,995,976,19,0.019095477386934675
28,2021-03-02,43357,42419,938,0.02163433816915377
29,2021-03-19,39547,39437,110,0.002781500493084178
30,2021-03-23,44352,44134,218,0.004915223665223665
31,2021-03-25,2555,2545,10,0.003913894324853229
32,2021-03-26,39739,39524,215,0.005410302221998541
33,2021-03-30,34238,34119,119,0.003475670307845084
34,2021-04-02,36270,36146,124,0.003418803418803419
35,2021-04-06,46391,45970,421,0.009075036106141278
36,2021-04-08,424,419,5,0.01179245283018868
37,2021-04-09,45898,45349,549,0.011961305503507777
38,2021-04-12,6429,6402,27,0.004199720018665422
39,2021-04-13,33851,33657,194,0.005730997607160793
40,2021-04-15,2867,2851,16,0.0055807464248343215
41,2021-04-16,31900,31714,186,0.005830721003134796
42,2021-04-19,8720,8660,60,0.006880733944954129
43,2021-04-20,37602,37351,251,0.006675176852295091
44,2021-04-22,9957,9900,57,0.005724615848147032
45,2021-04-23,34351,34073,278,0.008092923059008472
46,2021-04-29,34183,33877,306,0.008951818155223357
47,2021-05-03,30186,29990,196,0.006493076260518121
48,2021-05-06,42300,41990,310,0.007328605200945627
49,2021-05-10,48069,47687,382,0.007946909650710437
50,2021-05-13,46602,46164,438,0.009398738251577185
51,2021-05-17,41531,41373,158,0.0038043870843466328
52,2021-05-20,54993,54567,426,0.007746440456058044
53,2021-05-24,29548,29337,211,0.007140923243535942
54,2021-05-25,15270,15048,222,0.014538310412573674
55,2021-05-27,35057,34831,226,0.006446644036854266
56,2021-05-28,14760,14546,214,0.014498644986449864
57,2021-06-04,935,855,80,0.0855614973262032
58,2021-06-07,36270,36012,258,0.007113316790736146
59,2021-06-08,15289,15010,279,0.018248413892340897
60,2021-06-10,38266,37997,269,0.007029739194062614
61,2021-06-11,13292,13129,163,0.01226301534757749
62,2021-06-14,26208,26173,35,0.0013354700854700855
63,2021-06-15,12096,11921,175,0.014467592592592593
64,2021-06-17,26208,26135,73,0.0027854090354090355
65,2021-06-18,10080,9966,114,0.01130952380952381
66,2021-06-21,38285,38116,169,0.004414261460101867
67,2021-06-22,10080,9968,112,0.011111111111111112
68,2021-06-24,34272,34127,145,0.004230859010270775
69,2021-06-25,14112,13992,120,0.008503401360544218
70,2021-06-28,32256,32105,151,0.004681299603174603
71,2021-06-29,16104,15995,109,0.0067685047193243916
72,2021-07-01,32208,32180,28,0.0008693492300049677
73,2021-07-02,14091,13977,114,0.008090270385352353
74,2021-07-05,30240,30095,145,0.004794973544973545
75,2021-07-06,16087,15948,139,0.008640517187791385
76,2021-07-07,3385,3374,11,0.0032496307237813884
77,2021-07-08,34900,34784,116,0.00332378223495702
78,2021-07-09,16120,15991,129,0.008002481389578164
79,2021-07-12,34221,34075,146,0.004266386137167236
80,2021-07-13,14077,13961,116,0.00824039212900476
81,2021-07-15,36198,36049,149,0.004116249516547875
82,2021-07-16,10055,10010,45,0.0044753853804077575
83,2021-07-19,28182,27808,374,0.01327088212334114
84,2021-07-22,24156,24108,48,0.001987083954297069
85,2021-07-23,14091,13818,273,0.019374068554396422
86,2021-07-26,20150,20120,30,0.001488833746898263
87,2021-07-27,12084,11963,121,0.01001324064879179
88,2021-07-29,34238,34084,154,0.004497926280740697
89,2021-07-30,14098,13846,252,0.01787487586891758
90,2021-08-02,32256,32109,147,0.004557291666666667
91,2021-08-03,14744,14532,212,0.014378730330982095
92,2021-08-05,32224,32055,169,0.005244538232373386
93,2021-08-06,12583,12380,203,0.016132877692124296
94,2021-08-09,31844,31671,173,0.005432734581082779
95,2021-08-10,10090,10073,17,0.0016848364717542122
96,2021-08-12,26234,26050,184,0.007013798886940611
97,2021-08-13,12108,11926,182,0.01503138420878758
98,2021-08-16,26234,26065,169,0.006442021803766105
99,2021-08-20,39342,39208,134,0.003406029180011184
100,2021-08-21,4395,4392,3,0.0006825938566552901
101,2021-08-23,35056,34889,167,0.004763806481058877
102,2021-08-24,16136,16013,123,0.007622706990580069
103,2021-08-26,26221,26075,146,0.005568056138209832
104,2021-08-27,14119,14004,115,0.008145052765776614
105,2021-08-30,30270,30123,147,0.0048562933597621405
106,2021-08-31,15657,15536,121,0.007728172702305678
107,2021-09-03,14112,14001,111,0.007865646258503401
108,2021-09-06,24204,24172,32,0.0013220955214014213
109,2021-09-10,16096,15967,129,0.00801441351888668
110,2021-09-13,28196,27905,291,0.010320612852886935
111,2021-09-14,16120,16004,116,0.007196029776674938
112,2021-09-16,34255,34044,211,0.00615968471755948
113,2021-09-17,14105,13993,112,0.00794044665012407
114,2021-09-20,28224,28165,59,0.002090419501133787
115,2021-09-21,16120,16003,117,0.007258064516129033
116,2021-09-23,28989,28906,83,0.002863154989823726
117,2021-09-24,15751,15649,102,0.00647577931559901
118,2021-09-27,20170,20114,56,0.0027764005949429847
119,2021-09-28,16128,16005,123,0.007626488095238095
120,2021-09-30,21587,21410,177,0.008199379256033723
121,2021-10-01,12096,11983,113,0.009341931216931217
122,2021-10-04,30255,30112,143,0.004726491489010081
123,2021-10-05,16120,16007,113,0.007009925558312655
124,2021-10-07,34255,34107,148,0.004320537147861626
125,2021-10-08,16120,16005,115,0.007133995037220843
126,2021-10-11,32272,32001,271,0.008397372335151214
127,2021-10-14,34272,34125,147,0.00428921568627451
128,2021-10-15,14242,14115,127,0.008917286897907597
129,2021-10-18,28266,28158,108,0.00382084483124602
130,2021-10-19,16120,15981,139,0.008622828784119107
131,2021-10-21,24180,24059,121,0.00500413564929694
132,2021-10-22,14105,13982,123,0.008720311946118399
133,2021-10-25,28238,28081,157,0.005559883844464906
134,2021-10-26,16136,16009,127,0.007870599900842835
135,2021-10-28,36306,36111,195,0.005371013055693274
136,2021-10-29,16136,16005,131,0.008118492811105603
137,2021-11-01,32288,32144,144,0.0044598612487611496
138,2021-11-02,16120,16005,115,0.007133995037220843
139,2021-11-04,30225,30084,141,0.004665012406947891
140,2021-11-05,12090,12086,4,0.00033085194375516956
141,2021-11-08,33019,32839,180,0.005451406765801508
142,2021-11-11,26182,26047,135,0.005156214192956993
143,2021-11-15,30751,30700,51,0.0016584826509707
144,2021-11-18,34255,34213,42,0.0012260983797985694
145,2021-11-22,38285,38067,218,0.005694136084628445
146,2021-11-25,36957,36774,183,0.004951700625050735
147,2021-12-03,23258,23148,110,0.004729555421790352
148,2021-12-04,8937,8903,34,0.0038044086382454964
149,2021-12-06,34255,34104,151,0.0044081156035615235
150,2021-12-07,14084,13970,114,0.008094291394490201
151,2021-12-09,32192,32046,146,0.004535288270377733
152,2021-12-10,14084,13960,124,0.008804316955410394
153,2021-12-13,34238,34098,140,0.004089023891582453
154,2021-12-14,20150,20026,124,0.006153846153846154
155,2021-12-15,1008,1008,0,0.0
156,2021-12-16,25501,25469,32,0.0012548527508725149
157,2021-12-17,16063,15925,138,0.008591172259229285
158,2021-12-19,2955,2950,5,0.001692047377326565
159,2021-12-20,25617,25565,52,0.002029902018191045
160,2021-12-21,19764,19547,217,0.010979558793766444
161,2021-12-22,2334,2331,3,0.0012853470437017994
162,2021-12-23,26266,26159,107,0.004073707454503922
163,2021-12-24,21619,20871,748,0.03459919515241223
164,2021-12-26,1259,1258,1,0.0007942811755361397
165,2021-12-27,14887,14866,21,0.0014106267213004635
166,2021-12-28,20124,19885,239,0.011876366527529318
167,2021-12-29,1437,1434,3,0.0020876826722338203
168,2021-12-30,16038,16006,32,0.001995261254520514
169,2021-12-31,18741,18506,235,0.012539352222400085
170,2022-01-03,27306,27230,76,0.002783271075954003
171,2022-01-04,21030,20453,577,0.02743699476937708
172,2022-01-05,2338,2336,2,0.000855431993156544
173,2022-01-06,18873,18849,24,0.001271657924018439
174,2022-01-07,19049,18805,244,0.012809071342327682
175,2022-01-10,14105,14078,27,0.0019142148174406239
176,2022-01-12,651,643,8,0.01228878648233487
177,2022-01-13,9839,9777,62,0.006301453399735746
178,2022-01-14,18135,17883,252,0.013895781637717122
179,2022-01-16,2079,2077,2,0.000962000962000962
180,2022-01-17,16847,16785,62,0.0036801804475574285
181,2022-01-18,17362,17205,157,0.009042737011864992
182,2022-01-19,1949,1942,7,0.0035915854284248334
183,2022-01-20,21270,21202,68,0.0031969910672308417
184,2022-01-21,19057,18795,262,0.01374822899721887
185,2022-01-23,2592,2588,4,0.0015432098765432098
186,2022-01-24,20465,20412,53,0.002589787441974102
187,2022-01-25,19258,19026,232,0.012046941530792398
188,2022-01-26,2324,2319,5,0.0021514629948364886
189,2022-01-27,22663,22611,52,0.00229448881436703
190,2022-01-28,17349,17107,242,0.013948930774108017
191,2022-01-30,3023,3015,8,0.0026463777704267286
192,2022-01-31,22242,22180,62,0.0027875191079938856
193,2022-02-01,18308,18059,249,0.013600611754424296
194,2022-02-02,3163,3156,7,0.002213088839709137
195,2022-02-03,25742,25690,52,0.0020200450625437027
196,2022-02-04,19407,19163,244,0.012572783016437368
197,2022-02-06,2108,2099,9,0.004269449715370019
198,2022-02-07,20413,20370,43,0.002106500759320041
199,2022-02-08,17859,17635,224,0.012542695559661796
200,2022-02-09,1160,1160,0,0.0
201,2022-02-10,21202,21156,46,0.0021696066408829354
202,2022-02-11,19953,19731,222,0.011126146444143737
203,2022-02-13,2600,2599,1,0.0003846153846153846
204,2022-02-14,20120,20094,26,0.0012922465208747515
205,2022-02-15,19574,19352,222,0.011341575559415552
206,2022-02-16,3161,3154,7,0.002214489085732363
207,2022-02-17,23047,23024,23,0.0009979606890267714
208,2022-02-18,17836,17675,161,0.00902668759811617
209,2022-02-19,2216,2195,21,0.00947653429602888
210,2022-02-20,1953,1948,5,0.002560163850486431
211,2022-02-21,20795,20698,97,0.0046645828324116375
212,2022-02-22,19630,19406,224,0.01141110545084055
213,2022-02-23,1508,1508,0,0.0
214,2022-02-24,27078,27039,39,0.0014402836250830932
215,2022-02-25,17828,17703,125,0.007011442674444693
216,2022-02-28,18875,18832,43,0.0022781456953642385
217,2022-03-01,23503,22889,614,0.026124324554312215
218,2022-03-02,714,714,0,0.0
219,2022-03-03,28607,28540,67,0.002342084105288915
220,2022-03-04,20705,20415,290,0.014006278676648153
221,2022-03-06,171,171,0,0.0
222,2022-03-07,18428,18382,46,0.0024962014326025614
223,2022-03-08,23674,22777,897,0.03788966799020022
224,2022-03-09,612,612,0,0.0
225,2022-03-10,24599,24557,42,0.0017073864791251677
226,2022-03-11,19097,18934,163,0.008535372047965648
227,2022-03-14,24625,24600,25,0.0010152284263959391
228,2022-03-15,19544,19382,162,0.008288988948014737
229,2022-03-16,1899,1899,0,0.0
230,2022-03-17,16227,16219,8,0.0004930054846860172
231,2022-03-20,891,891,0,0.0
232,2022-03-21,18347,18324,23,0.0012536109445685944
233,2022-03-22,15017,14993,24,0.0015981887194512886
234,2022-03-23,788,786,2,0.0025380710659898475
235,2022-03-24,16555,16540,15,0.000906070673512534
236,2022-03-25,18909,18748,161,0.008514464011846211
237,2022-03-28,1065,1058,7,0.006572769953051643
238,2022-03-29,19085,18933,152,0.007964369924024103
239,2022-03-30,1387,1383,4,0.002883922134102379
240,2022-03-31,22618,22543,75,0.0033159430542046156
241,2022-04-01,17213,17040,173,0.010050543194097485
242,2022-04-03,1505,1505,0,0.0
243,2022-04-04,25592,25583,9,0.0003516723976242576
244,2022-04-05,19225,19060,165,0.008582574772431729
245,2022-04-06,544,543,1,0.001838235294117647
246,2022-04-07,16176,16136,40,0.002472799208704253
247,2022-04-08,19704,19449,255,0.012941534713763702
248,2022-04-10,1578,1576,2,0.0012674271229404308
249,2022-04-11,26632,26582,50,0.0018774406728747372
250,2022-04-12,16897,16751,146,0.008640587086465054
251,2022-04-13,845,845,0,0.0
252,2022-04-14,27130,27073,57,0.0021009952082565427
253,2022-04-15,17188,17070,118,0.00686525482895043
254,2022-04-17,3137,3131,6,0.001912655403251514
255,2022-04-18,24582,24564,18,0.000732243104710764
256,2022-04-19,12601,12436,165,0.01309419887310531
257,2022-04-20,2117,2111,6,0.002834199338686821
258,2022-04-21,22724,22658,66,0.0029044182362260164
259,2022-04-22,15601,15433,168,0.010768540478174476
260,2022-04-24,463,461,2,0.004319654427645789
261,2022-04-25,7593,7556,37,0.004872909258527592
262,2022-04-26,18099,18095,4,0.00022100668545223492
263,2022-04-27,4254,4247,7,0.0016455101081335214
264,2022-04-28,23900,23887,13,0.0005439330543933054
265,2022-04-29,14700,14568,132,0.008979591836734694
266,2022-04-30,2801,2778,23,0.008211353088182792
267,2022-05-02,27167,27093,74,0.0027238929583686088
268,2022-05-03,16325,16179,146,0.00894333843797856
269,2022-05-04,2025,2022,3,0.0014814814814814814
270,2022-05-05,28402,28269,133,0.004682768819097247
271,2022-05-06,15918,15769,149,0.009360472421158436
272,2022-05-09,12084,12040,44,0.003641178417742469
273,2022-05-10,19243,19219,24,0.0012472067764901522
274,2022-05-12,12060,12016,44,0.003648424543946932
275,2022-05-13,19298,18660,638,0.03306042076899161
276,2022-05-16,11943,11906,37,0.003098049066398727
277,2022-05-17,22120,21800,320,0.014466546112115732
278,2022-05-19,12018,11974,44,0.0036611749043102015
279,2022-05-20,22033,21717,316,0.014342123178868061
280,2022-05-23,12018,11978,40,0.003328340822100183
281,2022-05-24,20030,19724,306,0.01527708437343984
282,2022-05-26,12018,11984,34,0.0028290896987851555
283,2022-05-27,10015,9711,304,0.030354468297553668
284,2022-05-30,20030,19994,36,0.0017973040439340988
285,2022-05-31,17135,16813,322,0.01879194630872483
286,2022-06-02,18027,17992,35,0.0019415321462251068
287,2022-06-03,11094,11068,26,0.0023436091581034795
288,2022-06-06,18027,17992,35,0.0019415321462251068
289,2022-06-07,18027,17638,389,0.021578742996616187
290,2022-06-09,18432,18387,45,0.00244140625
291,2022-06-10,16024,15713,311,0.019408387418871693
292,2022-06-13,20010,19976,34,0.001699150424787606
293,2022-06-14,14541,14230,311,0.02138780001375421
294,2022-06-16,20030,19980,50,0.0024962556165751375
295,2022-06-17,16024,16012,12,0.0007488766849725411
296,2022-06-20,20020,19991,29,0.0014485514485514486
297,2022-06-21,18018,17715,303,0.016816516816516816
298,2022-06-23,20020,19989,31,0.0015484515484515485
299,2022-06-24,16016,16005,11,0.0006868131868131869
300,2022-06-27,20170,20133,37,0.0018344075359444719
301,2022-06-28,12102,12069,33,0.002726822012890431
302,2022-06-30,20170,20143,27,0.001338621715418939
303,2022-07-01,6051,6013,38,0.006279953726656751
304,2022-07-04,20170,20138,32,0.0015865146256817055
305,2022-07-05,14133,14122,11,0.0007783202434019671
306,2022-07-07,20433,20415,18,0.0008809279107326384
307,2022-07-08,9852,9852,0,0.0
308,2022-07-12,16152,16142,10,0.0006191183754333828
309,2022-07-14,20190,20157,33,0.0016344725111441308
310,2022-07-15,12114,12112,2,0.0001650982334489021
311,2022-07-18,22828,22797,31,0.001357981426318556
312,2022-07-19,11495,11491,4,0.00034797738147020446
313,2022-07-21,18778,18766,12,0.0006390456917669613
314,2022-07-22,11507,11506,1,8.690362388111584e-05
315,2022-07-25,22452,22422,30,0.0013361838588989846
316,2022-07-26,9852,9840,12,0.001218026796589525
317,2022-07-28,22694,22667,27,0.0011897417819688022
318,2022-07-29,13648,13638,10,0.0007327080890973036
319,2022-08-01,23247,23152,95,0.004086548801995956
320,2022-08-02,12955,12453,502,0.03874951756078734
321,2022-08-04,20698,20659,39,0.0018842400231906464
322,2022-08-05,11606,11603,3,0.00025848698948819574
323,2022-08-08,22829,22802,27,0.0011827062070173902
324,2022-08-09,11494,11477,17,0.0014790325387158518
325,2022-08-11,20811,20611,200,0.009610302244005574
326,2022-08-12,11509,11475,34,0.0029542097488921715
327,2022-08-15,20931,20854,77,0.0036787540012421767
328,2022-08-16,11389,11360,29,0.0025463166213012555
329,2022-08-18,23063,23014,49,0.002124615184494645
330,2022-08-19,11277,11274,3,0.00026602819898909286
331,2022-08-22,22793,22699,94,0.004124073180362392
332,2022-08-23,15340,14886,454,0.029595827900912648
333,2022-08-25,20200,20163,37,0.0018316831683168316
334,2022-08-26,16160,16077,83,0.005136138613861386
335,2022-08-29,25195,25132,63,0.0025004961301845602
336,2022-08-30,11165,11165,0,0.0
337,2022-09-01,22404,22371,33,0.0014729512587038029
338,2022-09-02,7896,7892,4,0.0005065856129685917
339,2022-09-05,24991,24931,60,0.0024008643111520147
340,2022-09-06,11405,11403,2,0.00017536168347216134
341,2022-09-08,22242,22174,68,0.003057279021670713
342,2022-09-09,16176,16156,20,0.0012363996043521265
343,2022-09-12,24655,24588,67,0.0027175015209896574
344,2022-09-13,11741,11739,2,0.00017034324163188826
345,2022-09-15,22684,22608,76,0.0033503791218479984
346,2022-09-16,10338,10316,22,0.0021280711936544788
347,2022-09-19,22209,22149,60,0.00270160745643658
348,2022-09-20,10090,10090,0,0.0
349,2022-09-22,23934,23892,42,0.0017548257708698922
350,2022-09-23,14408,14405,3,0.0002082176568573015
351,2022-09-26,2303,2303,0,0.0
352,2022-09-27,34046,34001,45,0.0013217411737061623
353,2022-09-29,24840,24779,61,0.002455716586151369
354,2022-09-30,13521,13516,5,0.0003697951334960432
355,2022-10-03,24224,24135,89,0.0036740422721268165
356,2022-10-04,14958,13600,1358,0.09078753844096804
357,2022-10-06,16628,16514,114,0.006855905701226846
358,2022-10-07,3552,3099,453,0.12753378378378377
359,2022-10-10,24062,24002,60,0.0024935583077050952
360,2022-10-11,13614,13599,15,0.0011018069634200088
361,2022-10-13,14100,14098,2,0.00014184397163120567
362,2022-10-14,14152,14147,5,0.00035330695308083665
363,2022-10-19,1275,1273,2,0.001568627450980392
364,2022-10-20,12701,12700,1,7.873395795606645e-05
365,2022-10-21,14276,14273,3,0.00021014289717007564
366,2022-10-23,1560,1559,1,0.000641025641025641
367,2022-10-24,12674,12674,0,0.0
368,2022-10-25,12958,12920,38,0.002932551319648094
369,2022-10-27,12811,12781,30,0.002341737569276403
370,2022-10-28,8290,8281,9,0.0010856453558504221
371,2022-10-30,1646,1644,2,0.001215066828675577
372,2022-10-31,12659,12658,1,7.899518129394107e-05
373,2022-11-01,11942,11928,14,0.0011723329425556857
374,2022-11-03,15240,15239,1,6.561679790026247e-05
375,2022-11-04,8988,8980,8,0.0008900756564307966
376,2022-11-06,2255,2255,0,0.0
377,2022-11-07,12510,12501,9,0.0007194244604316547
378,2022-11-08,10076,10065,11,0.001091703056768559
379,2022-11-09,1439,1398,41,0.02849200833912439
380,2022-11-10,13814,13229,585,0.04234834226147387
381,2022-11-11,10916,10909,7,0.0006412605349945035
382,2022-11-13,1654,1654,0,0.0
383,2022-11-14,13907,13895,12,0.0008628748112461351
384,2022-11-15,10725,10721,4,0.00037296037296037296
385,2022-11-16,1334,1295,39,0.02923538230884558
386,2022-11-17,14555,13962,593,0.04074201305393336
387,2022-11-18,12405,12404,1,8.061265618702137e-05
388,2022-11-20,1300,1300,0,0.0
389,2022-11-21,11215,11200,15,0.0013374944271065537
390,2022-11-22,11621,11617,4,0.00034420445744772393
391,2022-11-23,984,983,1,0.0010162601626016261
392,2022-11-24,12447,12436,11,0.0008837470876516429
393,2022-11-25,12855,12837,18,0.0014002333722287048
394,2022-11-27,504,504,0,0.0
395,2022-11-28,12608,12590,18,0.0014276649746192893
396,2022-11-29,10838,10832,6,0.0005536076766931168
397,2022-11-30,303,291,12,0.039603960396039604
398,2022-12-01,13091,12542,549,0.04193720876938355
399,2022-12-02,12738,12736,2,0.0001570105197048202
400,2022-12-04,454,448,6,0.013215859030837005
401,2022-12-05,9320,9306,14,0.0015021459227467812
402,2022-12-06,12516,12515,1,7.989773090444231e-05
403,2022-12-07,580,580,0,0.0
404,2022-12-08,10731,10712,19,0.0017705712421955083
405,2022-12-09,10073,10056,17,0.0016876799364638141
406,2022-12-11,580,580,0,0.0
407,2022-12-12,11160,11150,10,0.0008960573476702509
408,2022-12-13,12524,12509,15,0.0011977004152028106
409,2022-12-14,670,646,24,0.03582089552238806
410,2022-12-15,13092,12514,578,0.04414909868622059
411,2022-12-16,11904,11882,22,0.0018481182795698926
412,2022-12-19,11523,11513,10,0.0008678295582747548
413,2022-12-20,12328,12306,22,0.0017845554834523037
414,2022-12-21,467,467,0,0.0
415,2022-12-22,8710,8709,1,0.0001148105625717566
416,2022-12-23,9030,9026,4,0.00044296788482834997
417,2022-12-25,497,481,16,0.03219315895372234
418,2022-12-26,10816,10234,582,0.05380917159763313
419,2022-12-27,10951,10933,18,0.0016436855081727697
420,2022-12-29,8092,8092,0,0.0
421,2022-12-30,12138,12136,2,0.00016477179106936892
422,2023-01-01,1179,1139,40,0.033927056827820185
423,2023-01-02,11680,11163,517,0.04426369863013699
424,2023-01-03,9200,9198,2,0.0002173913043478261
425,2023-01-04,1079,1046,33,0.030583873957367932
426,2023-01-05,11889,11353,536,0.045083690806627975
427,2023-01-06,9200,9199,1,0.00010869565217391305
428,2023-01-08,753,753,0,0.0
429,2023-01-09,8494,8494,0,0.0
430,2023-01-10,8960,8959,1,0.00011160714285714285
431,2023-01-11,305,304,1,0.003278688524590164
432,2023-01-12,8871,8866,5,0.0005636343140570398
433,2023-01-13,11066,11056,10,0.0009036688957166094
434,2023-01-16,9594,9594,0,0.0
435,2023-01-17,16705,16679,26,0.0015564202334630351
436,2023-01-18,303,302,1,0.0033003300330033004
437,2023-01-19,9423,9387,36,0.0038204393505253103
438,2023-01-20,18606,18027,579,0.03111899387294421
439,2023-01-22,179,178,1,0.00558659217877095
440,2023-01-23,7240,7239,1,0.00013812154696132598
441,2023-01-24,18890,18846,44,0.0023292747485442033
442,2023-01-25,182,182,0,0.0
443,2023-01-26,7714,7690,24,0.00311122634171636
444,2023-01-27,17678,17604,74,0.004185993890711619
445,2023-01-30,9191,9176,15,0.001632031335001632
446,2023-01-31,11033,10992,41,0.003716124354210097
447,2023-02-01,432,432,0,0.0
448,2023-02-02,8244,8232,12,0.001455604075691412
449,2023-02-03,11078,11017,61,0.005506409099115364
450,2023-02-05,225,225,0,0.0
451,2023-02-06,10374,10300,74,0.007133217659533449
452,2023-02-07,7760,7751,9,0.0011597938144329897
453,2023-02-08,152,152,0,0.0
454,2023-02-09,4734,4733,1,0.00021123785382340515
455,2023-02-10,15648,15632,16,0.0010224948875255625
456,2023-02-13,10841,10811,30,0.0027672723918457705
457,2023-02-14,11634,11612,22,0.0018910091112257178
458,2023-02-15,855,852,3,0.0035087719298245615
459,2023-02-16,10442,10396,46,0.004405286343612335
460,2023-02-17,15069,14561,508,0.033711593337315014
461,2023-02-20,10610,10589,21,0.001979264844486334
462,2023-02-21,13925,13912,13,0.0009335727109515261
463,2023-02-22,462,462,0,0.0
464,2023-02-23,10282,10275,7,0.0006808014005057381
465,2023-02-24,13791,13768,23,0.0016677543325357117
466,2023-02-26,620,620,0,0.0
467,2023-02-27,9814,9800,14,0.0014265335235378032
468,2023-02-28,14349,13974,375,0.02613422538155969
469,2023-03-01,625,625,0,0.0
470,2023-03-02,9490,9471,19,0.0020021074815595365
471,2023-03-03,12267,12242,25,0.002037988098149507
472,2023-03-04,1139,1139,0,0.0
473,2023-03-05,545,545,0,0.0
474,2023-03-06,9570,9569,1,0.0001044932079414838
475,2023-03-07,14420,14384,36,0.0024965325936199723
476,2023-03-09,10740,10739,1,9.310986964618249e-05
477,2023-03-10,13795,13769,26,0.0018847408481333817
478,2023-03-13,10626,10617,9,0.0008469791078486731
479,2023-03-14,13909,13884,25,0.0017973973686102524
480,2023-03-15,436,436,0,0.0
481,2023-03-16,7656,7655,1,0.00013061650992685477
482,2023-03-17,12360,12259,101,0.008171521035598706
483,2023-03-19,704,703,1,0.0014204545454545455
484,2023-03-20,9411,9403,8,0.0008500690681117841
485,2023-03-21,14420,14402,18,0.0012482662968099861
486,2023-03-22,699,696,3,0.004291845493562232
487,2023-03-23,9416,9408,8,0.0008496176720475786
488,2023-03-24,14420,14411,9,0.0006241331484049931
489,2023-03-26,544,544,0,0.0
490,2023-03-27,10306,10305,1,9.703085581214826e-05
491,2023-03-28,13685,13684,1,7.307270734380708e-05
492,2023-03-29,544,543,1,0.001838235294117647
493,2023-03-30,10420,10411,9,0.0008637236084452975
494,2023-03-31,13571,13556,15,0.0011052980620440645
