,date,measurements,ok,anomalies,ratio
0,2021-01-01,6336,6138,198,0.03125
1,2021-01-04,124336,120884,3452,0.027763479603654613
2,2021-01-05,22560,21949,611,0.027083333333333334
3,2021-01-07,132171,128548,3623,0.027411459397295928
4,2021-01-08,21708,21083,625,0.02879122903998526
5,2021-01-11,125310,121929,3381,0.026981086904476898
6,2021-01-14,780,755,25,0.03205128205128205
7,2021-01-15,9300,8912,388,0.04172043010752688
8,2021-01-18,134759,131076,3683,0.02733027107651437
9,2021-01-19,21606,21013,593,0.02744607979265019
10,2021-01-21,132419,128771,3648,0.027548916696244496
11,2021-01-22,18254,17734,520,0.02848690697929221
12,2021-01-25,136760,133299,3461,0.025307107341327875
13,2021-01-26,8812,8487,325,0.03688152519291875
14,2021-01-28,133901,130366,3535,0.026400101567576044
15,2021-01-29,9145,8793,352,0.03849097867687261
16,2021-02-01,130305,127020,3285,0.025210084033613446
17,2021-02-04,132648,129322,3326,0.02507387974187323
18,2021-02-05,16086,15287,799,0.04967052094989432
19,2021-02-08,127925,124626,3299,0.02578854797733047
20,2021-02-09,14990,14219,771,0.0514342895263509
21,2021-02-10,1122,1063,59,0.05258467023172905
22,2021-02-11,131862,128444,3418,0.025921038661631098
23,2021-02-12,12253,11695,558,0.04553986778748062
24,2021-02-13,1845,1768,77,0.04173441734417344
25,2021-02-15,137964,134157,3807,0.02759415499695573
26,2021-02-16,11639,11127,512,0.043990033508033335
27,2021-02-18,145510,141279,4231,0.029077039378736857
28,2021-02-19,16278,15849,429,0.026354589015849614
29,2021-02-22,138276,134356,3920,0.02834909890364199
30,2021-02-23,8143,7689,454,0.05575340783495027
31,2021-02-24,21,21,0,0.0
32,2021-02-25,144045,139956,4089,0.028386962407580964
33,2021-02-26,8476,7998,478,0.056394525719679095
34,2021-03-01,137108,133129,3979,0.029020917816611723
35,2021-03-02,15181,14607,574,0.037810420920887954
36,2021-03-18,132928,129122,3806,0.028632041405873856
37,2021-03-19,20948,20250,698,0.03332060339889249
38,2021-03-20,659,622,37,0.05614567526555387
39,2021-03-22,142538,138514,4024,0.028231068206373038
40,2021-03-23,4032,3861,171,0.04241071428571429
41,2021-03-25,139342,135423,3919,0.02812504485366939
42,2021-03-26,4028,3855,173,0.0429493545183714
43,2021-03-29,116811,114085,2726,0.0233368432767462
44,2021-03-30,10104,9852,252,0.02494061757719715
45,2021-03-31,910,865,45,0.04945054945054945
46,2021-04-02,9910,9714,196,0.01977800201816347
47,2021-04-03,176,173,3,0.017045454545454544
48,2021-04-05,115955,113013,2942,0.025371911517398992
49,2021-04-06,19816,18859,957,0.04829430763019782
50,2021-04-07,354,337,17,0.0480225988700565
51,2021-04-08,115958,113027,2931,0.02527639317683989
52,2021-04-09,17899,17042,857,0.04787976981954299
53,2021-04-10,103,90,13,0.1262135922330097
54,2021-04-12,128478,124696,3782,0.02943694640327527
55,2021-04-13,15588,15102,486,0.03117782909930716
56,2021-04-15,133093,129061,4032,0.030294606027364324
57,2021-04-16,14973,14405,568,0.03793494957590329
58,2021-04-19,132588,128638,3950,0.029791534678854797
59,2021-04-20,6881,6746,135,0.019619241389332947
60,2021-04-22,136614,132047,4567,0.03342995593423807
61,2021-04-23,6698,6565,133,0.019856673633920574
62,2021-04-26,121336,118218,3118,0.025697237423353333
63,2021-04-27,397,337,60,0.15113350125944586
64,2021-04-29,112670,110046,2624,0.023289251797284104
65,2021-04-30,277,231,46,0.16606498194945848
66,2021-05-03,91473,89528,1945,0.021263104959933533
67,2021-05-06,123344,120180,3164,0.025651835516928265
68,2021-05-09,54549,53563,986,0.018075491759702286
69,2021-05-10,90307,87392,2915,0.03227878237567409
70,2021-05-13,142759,138402,4357,0.03051996721747841
71,2021-05-17,142961,138633,4328,0.030273990808682087
72,2021-05-18,135,112,23,0.17037037037037037
73,2021-05-20,134600,130210,4390,0.03261515601783061
74,2021-05-21,146,123,23,0.15753424657534246
75,2021-05-24,44018,42926,1092,0.024808033077377438
76,2021-05-25,88479,85488,2991,0.03380463160750009
77,2021-05-27,49333,48025,1308,0.02651369266008554
78,2021-05-28,88049,85221,2828,0.03211847948301514
79,2021-06-04,75526,72633,2893,0.03830468977570638
80,2021-06-07,48510,46866,1644,0.033889919604205315
81,2021-06-08,69508,67229,2279,0.03278759279507395
82,2021-06-10,50363,48780,1583,0.03143180509501023
83,2021-06-11,87995,85089,2906,0.03302460367066311
84,2021-06-14,47008,45477,1531,0.032568924438393466
85,2021-06-15,72600,70033,2567,0.03535812672176308
86,2021-06-17,46381,45039,1342,0.02893426187447446
87,2021-06-18,66528,64347,2181,0.03278318903318903
88,2021-06-21,31480,30523,957,0.030400254129606098
89,2021-06-22,86717,83772,2945,0.0339610457003817
90,2021-06-24,41298,39974,1324,0.03205966390624243
91,2021-06-25,83152,80425,2727,0.03279536270925534
92,2021-06-28,45581,44060,1521,0.03336916697746868
93,2021-06-29,87901,84898,3003,0.034163433863095984
94,2021-07-01,37637,36487,1150,0.03055503892446263
95,2021-07-02,88572,85311,3261,0.0368175044031974
96,2021-07-05,36301,34834,1467,0.04041210985923253
97,2021-07-06,91930,88539,3391,0.03688676166648537
98,2021-07-07,3668,3534,134,0.03653217011995638
99,2021-07-08,37711,36532,1179,0.031264087401553925
100,2021-07-09,76570,73751,2819,0.03681598537286143
101,2021-07-12,36247,35006,1241,0.03423731619168483
102,2021-07-13,80105,77193,2912,0.036352287622495476
103,2021-07-15,40788,39324,1464,0.03589290967931744
104,2021-07-16,62352,60277,2075,0.03327880420836541
105,2021-07-19,32221,31070,1151,0.03572204462927904
106,2021-07-22,34234,33162,1072,0.0313138984635158
107,2021-07-23,76679,73787,2892,0.03771567182670614
108,2021-07-26,23230,22326,904,0.03891519586741283
109,2021-07-27,66474,63848,2626,0.03950416704275356
110,2021-07-29,40609,39468,1141,0.02809721982811692
111,2021-07-30,67935,65440,2495,0.03672628247589608
112,2021-08-02,36757,35481,1276,0.03471447615420192
113,2021-08-03,69867,67283,2584,0.03698455637139136
114,2021-08-05,46075,44561,1514,0.03285946825827455
115,2021-08-06,86614,83408,3206,0.037014801302329876
116,2021-08-09,45633,43635,1998,0.043784103609230164
117,2021-08-10,72661,69962,2699,0.03714509847098168
118,2021-08-12,38355,36933,1422,0.03707469691044193
119,2021-08-13,68425,66145,2280,0.03332115454877603
120,2021-08-16,32314,31296,1018,0.03150337315095624
121,2021-08-20,104997,101655,3342,0.03182948084230978
122,2021-08-21,5427,5159,268,0.04938271604938271
123,2021-08-23,32301,31282,1019,0.03154701092845423
124,2021-08-24,86792,83904,2888,0.03327495621716287
125,2021-08-26,26858,25724,1134,0.042222056742869905
126,2021-08-27,66298,63853,2445,0.0368789405411928
127,2021-08-30,30770,29770,1000,0.032499187520311994
128,2021-08-31,74605,72077,2528,0.03388512834260438
129,2021-09-03,76620,74091,2529,0.03300704776820673
130,2021-09-06,34641,33349,1292,0.03729684477930776
131,2021-09-10,84952,81996,2956,0.03479612016197382
132,2021-09-13,36252,35074,1178,0.03249475890985325
133,2021-09-14,82355,79442,2913,0.035371258575678466
134,2021-09-16,44342,42967,1375,0.03100897568896306
135,2021-09-17,74566,72097,2469,0.03311160582571145
136,2021-09-20,44365,42983,1382,0.031150681843795786
137,2021-09-21,90688,87748,2940,0.03241884262526464
138,2021-09-23,36929,35708,1221,0.03306344607219259
139,2021-09-24,87818,84842,2976,0.03388826891981143
140,2021-09-27,36319,35304,1015,0.027946804702772655
141,2021-09-28,92749,89711,3038,0.032755070135527066
142,2021-09-30,24205,23463,742,0.03065482338359843
143,2021-10-01,84690,82135,2555,0.03016885110402645
144,2021-10-04,37649,36382,1267,0.033652952269648595
145,2021-10-05,78597,75951,2646,0.03366540707660598
146,2021-10-07,35740,34758,982,0.027476217123670956
147,2021-10-08,82411,79957,2454,0.02977757823591511
148,2021-10-11,30266,29253,1013,0.03346990021806648
149,2021-10-14,30912,30174,738,0.023874223602484472
150,2021-10-15,88052,85474,2578,0.029278153818198337
151,2021-10-18,26260,25518,742,0.028255902513328254
152,2021-10-19,86658,84184,2474,0.028549008747028547
153,2021-10-21,36283,35295,988,0.02723038337513436
154,2021-10-22,63948,62023,1925,0.03010258334897104
155,2021-10-25,32272,31477,795,0.02463435795736242
156,2021-10-26,85179,82924,2255,0.02647366134845443
157,2021-10-28,36945,36037,908,0.02457707402896197
158,2021-10-29,78676,76572,2104,0.026742589862219737
159,2021-11-01,34319,33413,906,0.02639937061103179
160,2021-11-02,84630,82335,2295,0.027118043247075504
161,2021-11-04,30238,29410,828,0.027382763410278458
162,2021-11-05,78598,76423,2175,0.027672459859029493
163,2021-11-08,32204,31486,718,0.022295367035150913
164,2021-11-11,32237,31523,714,0.022148462946303935
165,2021-11-15,26195,25561,634,0.024203092193166634
166,2021-11-18,30238,29488,750,0.0248032277267015
167,2021-11-22,34933,33299,1634,0.04677525548907909
168,2021-11-25,33281,32137,1144,0.034373967128391573
169,2021-12-03,25017,24173,844,0.03373705880001599
170,2021-12-04,11266,10498,768,0.06816971418427126
171,2021-12-06,32251,29868,2383,0.07388918173079904
172,2021-12-07,68452,63050,5402,0.07891661310115117
173,2021-12-09,29728,27456,2272,0.07642626480086114
174,2021-12-10,55994,51390,4604,0.08222309533164268
175,2021-12-13,36252,33355,2897,0.07991283239545405
176,2021-12-14,32945,30332,2613,0.0793140081954773
177,2021-12-15,2364,2230,134,0.05668358714043993
178,2021-12-16,61471,56385,5086,0.08273820175367247
179,2021-12-17,28760,26594,2166,0.07531293463143254
180,2021-12-19,6702,6186,516,0.07699194270367055
181,2021-12-20,61203,56029,5174,0.08453833962387465
182,2021-12-21,30806,28303,2503,0.0812504057651107
183,2021-12-22,4435,4056,379,0.085456595264938
184,2021-12-23,53278,48454,4824,0.0905439393370622
185,2021-12-24,30820,28258,2562,0.08312783906554186
186,2021-12-26,1872,1719,153,0.08173076923076923
187,2021-12-27,23248,21108,2140,0.0920509291121817
188,2021-12-28,30656,28282,2374,0.07743997912317328
189,2021-12-29,4105,3752,353,0.08599269183922047
190,2021-12-30,48292,44191,4101,0.08492089787128303
191,2021-12-31,29769,27508,2261,0.0759514931640297
192,2022-01-03,73871,67821,6050,0.08189952755479146
193,2022-01-04,30017,27668,2349,0.07825565512876037
194,2022-01-05,5795,5387,408,0.07040552200172563
195,2022-01-06,46784,43277,3507,0.07496152530779754
196,2022-01-07,27965,26172,1793,0.06411585910960128
197,2022-01-10,50375,46983,3392,0.0673349875930521
198,2022-01-12,2332,2251,81,0.034734133790737566
199,2022-01-13,42501,39426,3075,0.07235123879438131
200,2022-01-14,31810,29560,2250,0.0707324740647595
201,2022-01-16,7385,6877,508,0.06878808395396073
202,2022-01-17,57391,52607,4784,0.08335801780767019
203,2022-01-18,27973,25811,2162,0.07728881421370608
204,2022-01-19,6244,5786,458,0.07335041639974375
205,2022-01-20,66606,61206,5400,0.08107377713719485
206,2022-01-21,29701,27481,2220,0.07474495808221945
207,2022-01-23,4929,4617,312,0.06329884357881924
208,2022-01-24,38143,35238,2905,0.07616076344283355
209,2022-01-25,25004,23103,1901,0.0760278355463126
210,2022-01-26,3971,3717,254,0.063963737093931
211,2022-01-27,39005,35999,3006,0.07706704268683502
212,2022-01-28,24731,22764,1967,0.07953580526464761
213,2022-01-30,4344,4056,288,0.06629834254143646
214,2022-01-31,33749,31187,2562,0.07591336039586358
215,2022-02-01,24460,22598,1862,0.07612428454619788
216,2022-02-02,5451,5087,364,0.0667767382131719
217,2022-02-03,41130,37863,3267,0.07943107221006565
218,2022-02-04,24333,22435,1898,0.07800106850778778
219,2022-02-06,4524,4240,284,0.0627763041556145
220,2022-02-07,45343,42064,3279,0.07231546214410163
221,2022-02-08,28701,26585,2116,0.07372565415839169
222,2022-02-09,2431,2332,99,0.04072398190045249
223,2022-02-10,44135,40765,3370,0.07635663305766399
224,2022-02-11,27320,25223,2097,0.07675695461200585
225,2022-02-13,5568,5238,330,0.059267241379310345
226,2022-02-14,43087,39856,3231,0.07498781535033769
227,2022-02-15,28141,26014,2127,0.07558366795778401
228,2022-02-16,6587,6206,381,0.057841202368301196
229,2022-02-17,51877,47966,3911,0.0753898644871523
230,2022-02-18,27164,25531,1633,0.060116330437343546
231,2022-02-19,5116,4470,646,0.12627052384675527
232,2022-02-20,4123,3861,262,0.06354596167838952
233,2022-02-21,45199,41961,3238,0.07163875306975818
234,2022-02-22,28677,26561,2116,0.07378735572061233
235,2022-02-23,2559,2466,93,0.03634232121922626
236,2022-02-24,47411,44241,3170,0.06686212060492291
237,2022-02-25,28756,26579,2177,0.07570593962999027
238,2022-02-28,27083,24423,2660,0.09821659343499613
239,2022-03-01,29368,26671,2697,0.0918346499591392
240,2022-03-02,1223,1134,89,0.07277187244480784
241,2022-03-03,52873,48643,4230,0.08000302611919127
242,2022-03-04,27219,24946,2273,0.08350784378559095
243,2022-03-06,458,434,24,0.05240174672489083
244,2022-03-07,49316,45232,4084,0.08281288020115175
245,2022-03-08,29622,26972,2650,0.08946053608804268
246,2022-03-09,878,819,59,0.06719817767653759
247,2022-03-10,38979,35836,3143,0.08063316144590676
248,2022-03-11,28116,25787,2329,0.08283539621567791
249,2022-03-14,34898,32102,2796,0.08011920453894206
250,2022-03-15,28707,26264,2443,0.08510119483052914
251,2022-03-16,3180,2923,257,0.08081761006289308
252,2022-03-17,27386,25195,2191,0.08000438180092018
253,2022-03-20,1751,1652,99,0.05653912050256996
254,2022-03-21,37513,34386,3127,0.08335776930664036
255,2022-03-22,24085,21926,2159,0.0896408553041312
256,2022-03-23,1618,1503,115,0.07107540173053152
257,2022-03-24,36247,33413,2834,0.07818578089221177
258,2022-03-25,26316,24200,2116,0.08040735674114607
259,2022-03-28,1338,1231,107,0.07997010463378176
260,2022-03-29,24883,22810,2073,0.08330989028654101
261,2022-03-30,2548,2399,149,0.05847723704866562
262,2022-03-31,44633,41074,3559,0.07973920641677683
263,2022-04-01,25472,23294,2178,0.08550565326633165
264,2022-04-03,2882,2645,237,0.08223455933379598
265,2022-04-04,54702,50104,4598,0.08405542758948485
266,2022-04-05,26352,24076,2276,0.08636915604128718
267,2022-04-06,1318,1238,80,0.06069802731411229
268,2022-04-07,41688,38543,3145,0.07544137401650355
269,2022-04-08,24857,22834,2023,0.08138552520416784
270,2022-04-10,2806,2570,236,0.08410548823948681
271,2022-04-11,52556,47915,4641,0.08830580713905167
272,2022-04-12,22692,20603,2089,0.09205887537458135
273,2022-04-13,1386,1291,95,0.06854256854256854
274,2022-04-14,48487,44440,4047,0.08346567121084002
275,2022-04-15,22619,20632,1987,0.08784650072947522
276,2022-04-17,4562,4183,379,0.08307759754493643
277,2022-04-18,40406,36758,3648,0.09028362124436964
278,2022-04-19,23601,21342,2259,0.09571628320833862
279,2022-04-20,3892,3600,292,0.0750256937307297
280,2022-04-21,47922,43919,4003,0.08353157213805767
281,2022-04-22,22011,20100,1911,0.08682022625051111
282,2022-04-24,619,574,45,0.07269789983844911
283,2022-04-25,11444,10570,874,0.076371897937784
284,2022-04-26,29096,26737,2359,0.08107643662359088
285,2022-04-27,7380,6802,578,0.07831978319783198
286,2022-04-28,46917,42984,3933,0.0838288893151736
287,2022-04-29,20730,19151,1579,0.07616980221900627
288,2022-04-30,6187,5518,669,0.108129949894941
289,2022-05-02,54991,50349,4642,0.08441381316942773
290,2022-05-03,25595,23393,2202,0.08603242820863449
291,2022-05-04,3331,3096,235,0.07054938456919845
292,2022-05-05,50270,46163,4107,0.081698826337776
293,2022-05-06,25008,22891,2117,0.0846529110684581
294,2022-05-09,22716,20964,1752,0.07712625462229265
295,2022-05-10,40357,37039,3318,0.08221622023440792
296,2022-05-12,22110,20540,1570,0.0710085933966531
297,2022-05-13,26130,23945,2185,0.08362035973976273
298,2022-05-16,20756,19393,1363,0.06566775872037002
299,2022-05-17,39356,36640,2716,0.06901107836162211
300,2022-05-19,22033,20574,1459,0.066218853537875
301,2022-05-20,39494,36803,2691,0.06813693219223173
302,2022-05-23,16024,14957,1067,0.0665876185721418
303,2022-05-24,36054,33562,2492,0.0691185444056138
304,2022-05-26,22033,20614,1419,0.06440339490763854
305,2022-05-27,20030,18804,1226,0.06120818771842237
306,2022-05-30,20734,19328,1406,0.06781132439471399
307,2022-05-31,36054,33605,2449,0.06792588894436123
308,2022-06-02,22033,20538,1495,0.06785276630508782
309,2022-06-03,34292,32015,2277,0.06640032660678875
310,2022-06-06,18027,16806,1221,0.06773173572973873
311,2022-06-07,29006,26773,2233,0.07698407226091153
312,2022-06-09,20981,19565,1416,0.06748963347790858
313,2022-06-10,41578,38761,2817,0.06775217663187262
314,2022-06-13,21123,19707,1416,0.06703593239596649
315,2022-06-14,36100,33564,2536,0.07024930747922438
316,2022-06-16,22033,20437,1596,0.07243679934643489
317,2022-06-17,39234,36477,2757,0.07027068359076312
318,2022-06-20,22022,20504,1518,0.06893106893106893
319,2022-06-21,40040,37277,2763,0.06900599400599401
320,2022-06-23,22022,20501,1521,0.0690672963400236
321,2022-06-24,38346,35692,2654,0.06921191258540656
322,2022-06-27,20294,18886,1408,0.06938011234847738
323,2022-06-28,40340,37445,2895,0.07176499752107089
324,2022-06-30,18153,16882,1271,0.0700159753208836
325,2022-07-01,25633,23848,1785,0.0696367963172473
326,2022-07-04,20170,18687,1483,0.07352503718393653
327,2022-07-05,42399,39414,2985,0.07040260383499611
328,2022-07-07,29438,27672,1766,0.05999048848427203
329,2022-07-08,38057,35178,2879,0.07564968336968232
330,2022-07-12,44418,41323,3095,0.06967895898059345
331,2022-07-14,18427,17156,1271,0.06897487382645032
332,2022-07-15,33390,31239,2151,0.06442048517520216
333,2022-07-18,27107,25501,1606,0.059246689047109606
334,2022-07-19,31444,29128,2316,0.07365475130390535
335,2022-07-21,26123,24578,1545,0.05914328369635953
336,2022-07-22,36466,33637,2829,0.07757911479186091
337,2022-07-25,21796,20481,1315,0.0603321710405579
338,2022-07-26,29859,27710,2149,0.07197159985264075
339,2022-07-28,22226,20876,1350,0.06073967425537659
340,2022-07-29,34306,31722,2584,0.0753221010901883
341,2022-08-01,24415,22963,1452,0.0594716362891665
342,2022-08-02,34578,31945,2633,0.07614668286193534
343,2022-08-04,22234,20950,1284,0.05774939282180444
344,2022-08-05,33818,31421,2397,0.07087941333017919
345,2022-08-08,23470,22121,1349,0.05747763101832126
346,2022-08-09,33062,30631,2431,0.07352852217046761
347,2022-08-11,22562,21196,1366,0.06054427798953994
348,2022-08-12,34864,32285,2579,0.0739731528223956
349,2022-08-15,23689,22445,1244,0.052513824982059185
350,2022-08-16,35318,32659,2659,0.07528738886686676
351,2022-08-18,21994,20638,1356,0.06165317813949259
352,2022-08-19,27636,25523,2113,0.07645824287161673
353,2022-08-22,20788,19436,1352,0.0650375216471041
354,2022-08-23,30866,28637,2229,0.07221538262165489
355,2022-08-25,18180,16903,1277,0.07024202420242025
356,2022-08-26,40017,37114,2903,0.07254416872829048
357,2022-08-29,27479,25824,1655,0.06022781032788675
358,2022-08-30,35720,32949,2771,0.07757558790593505
359,2022-09-01,27441,25756,1685,0.06140446776720965
360,2022-09-02,34183,31504,2679,0.07837229031974959
361,2022-09-05,26417,24734,1683,0.063708975281069
362,2022-09-06,36265,33460,2805,0.07734730456362884
363,2022-09-08,15370,14235,1135,0.07384515289525048
364,2022-09-09,42536,39444,3092,0.0726913673123942
365,2022-09-12,21976,20546,1430,0.06507098653076084
366,2022-09-13,28845,26680,2165,0.0750563355867568
367,2022-09-15,24889,23251,1638,0.06581220619550805
368,2022-09-16,38481,35483,2998,0.07790857825940074
369,2022-09-19,16513,15313,1200,0.07267001756192092
370,2022-09-20,14613,13627,986,0.06747416683774721
371,2022-09-22,22882,21372,1510,0.06599073507560528
372,2022-09-23,41694,38734,2960,0.07099342831102796
373,2022-09-26,5904,5550,354,0.059959349593495935
374,2022-09-27,48010,44671,3339,0.06954801083107685
375,2022-09-29,23630,22090,1540,0.06517139229792636
376,2022-09-30,34009,31611,2398,0.07051074715516481
377,2022-10-03,20510,19137,1373,0.06694295465626524
378,2022-10-04,35994,33459,2535,0.07042840473412236
379,2022-10-06,22653,21148,1505,0.06643711649671125
380,2022-10-07,29352,27266,2086,0.07106841101117471
381,2022-10-10,22571,21014,1557,0.06898232244916043
382,2022-10-11,35725,33107,2618,0.07328201539538139
383,2022-10-13,24947,23213,1734,0.06950735559385898
384,2022-10-14,30479,28282,2197,0.07208241740214574
385,2022-10-19,2219,2101,118,0.05317710680486706
386,2022-10-20,23760,22044,1716,0.07222222222222222
387,2022-10-21,28009,25954,2055,0.07336927416187654
388,2022-10-23,2730,2566,164,0.060073260073260075
389,2022-10-24,24005,22266,1739,0.07244324099146011
390,2022-10-25,31816,29324,2492,0.07832537088257481
391,2022-10-27,21052,19371,1681,0.0798498954968649
392,2022-10-28,6680,6178,502,0.0751497005988024
393,2022-10-30,2910,2742,168,0.0577319587628866
394,2022-10-31,23358,21773,1585,0.06785683705796729
395,2022-11-01,31066,28716,2350,0.07564540011588232
396,2022-11-03,25421,23817,1604,0.06309743912513277
397,2022-11-04,27267,25073,2194,0.08046356401510985
398,2022-11-06,3245,3088,157,0.04838212634822804
399,2022-11-07,21477,20033,1444,0.0672347162080365
400,2022-11-08,28250,26091,2159,0.07642477876106195
401,2022-11-09,2256,2146,110,0.04875886524822695
402,2022-11-10,23245,21613,1632,0.0702086470208647
403,2022-11-11,31039,28799,2240,0.07216727343020071
404,2022-11-13,2657,2508,149,0.05607828377869778
405,2022-11-14,25109,23459,1650,0.06571348918714405
406,2022-11-15,23605,21787,1818,0.07701758102097013
407,2022-11-16,1900,1802,98,0.05157894736842105
408,2022-11-17,22655,21077,1578,0.06965349812403443
409,2022-11-18,32033,29749,2284,0.0713014703586926
410,2022-11-20,2502,2352,150,0.05995203836930456
411,2022-11-21,23961,22385,1576,0.06577354868327699
412,2022-11-22,30125,27876,2249,0.07465560165975103
413,2022-11-23,1265,1194,71,0.05612648221343874
414,2022-11-24,17978,16722,1256,0.06986316609189008
415,2022-11-25,29998,27839,2159,0.07197146476431762
416,2022-11-27,650,617,33,0.05076923076923077
417,2022-11-28,17295,16092,1203,0.06955767562879445
418,2022-11-29,28900,26526,2374,0.08214532871972319
419,2022-11-30,404,387,17,0.04207920792079208
420,2022-12-01,18743,17437,1306,0.06967934695619699
421,2022-12-02,27073,25084,1989,0.07346803087947401
422,2022-12-04,669,626,43,0.06427503736920777
423,2022-12-05,17289,16097,1192,0.06894557232922667
424,2022-12-06,29861,27669,2192,0.0734067847694317
425,2022-12-07,894,839,55,0.06152125279642058
426,2022-12-08,17331,16094,1237,0.07137499278749063
427,2022-12-09,27403,25279,2124,0.07750976170492282
428,2022-12-11,889,840,49,0.05511811023622047
429,2022-12-12,17610,16403,1207,0.06854060193072119
430,2022-12-13,26929,24955,1974,0.07330387314790746
431,2022-12-14,901,851,50,0.05549389567147614
432,2022-12-15,18632,17336,1296,0.0695577501073422
433,2022-12-16,26919,24953,1966,0.07303391656450833
434,2022-12-19,18902,17605,1297,0.06861707755793038
435,2022-12-20,23972,22203,1769,0.07379442683130319
436,2022-12-21,897,848,49,0.054626532887402456
437,2022-12-22,17131,15952,1179,0.06882260229992411
438,2022-12-23,21758,20165,1593,0.07321444985752366
439,2022-12-25,836,787,49,0.05861244019138756
440,2022-12-26,16885,15729,1156,0.06846313295824696
441,2022-12-27,24299,22518,1781,0.0732951973332236
442,2022-12-29,12138,11242,896,0.07381776239907728
443,2022-12-30,28322,26311,2011,0.0710048725372502
444,2023-01-01,995,950,45,0.04522613065326633
445,2023-01-02,11956,11194,762,0.06373369019739043
446,2023-01-03,29532,27423,2109,0.07141405932547745
447,2023-01-04,920,875,45,0.04891304347826087
448,2023-01-05,12025,11268,757,0.06295218295218295
449,2023-01-06,29538,27385,2153,0.07288915972645406
450,2023-01-08,1096,1045,51,0.046532846715328466
451,2023-01-09,14741,13793,948,0.06431042670103793
452,2023-01-10,32390,29912,2478,0.0765050941648657
453,2023-01-11,444,423,21,0.0472972972972973
454,2023-01-12,14129,13257,872,0.06171703588364357
455,2023-01-13,35128,32539,2589,0.07370189023001594
456,2023-01-16,8892,8266,626,0.07040035987404408
457,2023-01-17,31653,29432,2221,0.07016712475910657
458,2023-01-18,294,279,15,0.05102040816326531
459,2023-01-19,10534,9794,740,0.07024871843554205
460,2023-01-20,30961,28830,2131,0.06882852621039372
461,2023-01-22,230,218,12,0.05217391304347826
462,2023-01-23,10173,9489,684,0.06723680330286051
463,2023-01-24,34121,31703,2418,0.0708654494299698
464,2023-01-25,232,220,12,0.05172413793103448
465,2023-01-26,8889,8269,620,0.0697491281358983
466,2023-01-27,11109,10339,770,0.06931316950220542
467,2023-01-30,12807,12001,806,0.06293433278675724
468,2023-01-31,27638,25625,2013,0.07283450322020407
469,2023-02-01,519,488,31,0.05973025048169557
470,2023-02-02,10654,9966,688,0.0645766848132157
471,2023-02-03,29857,27612,2245,0.07519174732893459
472,2023-02-05,174,166,8,0.04597701149425287
473,2023-02-06,6164,5715,449,0.07284231018818949
474,2023-02-07,30193,28159,2034,0.06736660815420793
475,2023-02-08,296,283,13,0.04391891891891892
476,2023-02-09,9419,8699,720,0.07644123579997876
477,2023-02-10,31266,29055,2211,0.07071579351372098
478,2023-02-13,19726,18410,1316,0.0667139815471966
479,2023-02-14,25261,23421,1840,0.07283955504532678
480,2023-02-15,1489,1414,75,0.050369375419744795
481,2023-02-16,18633,17396,1237,0.06638759190683197
482,2023-02-17,24230,22463,1767,0.07292612463887742
483,2023-02-20,19134,17878,1256,0.06564231211456047
484,2023-02-21,24475,22707,1768,0.07223697650663943
485,2023-02-22,806,770,36,0.04466501240694789
486,2023-02-23,18529,17294,1235,0.06665227481245616
487,2023-02-24,24397,22632,1765,0.07234496044595647
488,2023-02-26,1058,992,66,0.062381852551984876
489,2023-02-27,17631,16479,1152,0.06533945890760592
490,2023-02-28,23022,21342,1680,0.07297367735209799
491,2023-03-01,1077,1005,72,0.06685236768802229
492,2023-03-02,17130,16004,1126,0.06573263280793928
493,2023-03-03,22565,21046,1519,0.06731664081542212
494,2023-03-04,4215,3754,461,0.10937129300118624
495,2023-03-05,943,889,54,0.05726405090137858
496,2023-03-06,16548,15414,1134,0.06852791878172589
497,2023-03-07,24720,22943,1777,0.07188511326860841
498,2023-03-09,17281,16059,1222,0.07071350037613564
499,2023-03-10,21772,20207,1565,0.07188131545103803
500,2023-03-13,19058,17709,1349,0.07078392276209466
501,2023-03-14,21737,20180,1557,0.07162901964392511
502,2023-03-15,524,492,32,0.061068702290076333
503,2023-03-16,8707,8062,645,0.07407832778224417
504,2023-03-17,24403,22563,1840,0.07540056550424128
505,2023-03-19,1204,1127,77,0.06395348837209303
506,2023-03-20,17003,15748,1255,0.07381050402870082
507,2023-03-21,26129,24173,1956,0.07485935167821195
508,2023-03-22,1209,1130,79,0.065343258891646
509,2023-03-23,16998,15783,1215,0.07147899752912107
510,2023-03-24,26780,24761,2019,0.07539208364451083
511,2023-03-26,836,787,49,0.05861244019138756
512,2023-03-27,16432,15276,1156,0.07035053554040896
513,2023-03-28,24028,22212,1816,0.07557849175961379
514,2023-03-29,908,852,56,0.06167400881057269
515,2023-03-30,18678,17188,1490,0.07977299496734126
516,2023-03-31,22911,21185,1726,0.07533499192527607
