,date,measurements,ok,anomalies,ratio
0,2021-01-01,79743,58875,20868,0.2616906813137203
1,2021-01-04,2441,1958,483,0.19786972552232693
2,2021-01-05,65653,48930,16723,0.25471798699221665
3,2021-01-07,3868,3090,778,0.20113753877973112
4,2021-01-08,72522,53480,19042,0.26256859987314196
5,2021-01-14,3540,2818,722,0.20395480225988702
6,2021-01-15,67073,49400,17673,0.26348903433572374
7,2021-01-18,3258,2622,636,0.19521178637200737
8,2021-01-19,67203,49809,17394,0.2588277309048703
9,2021-01-21,5862,4673,1189,0.2028317980211532
10,2021-01-22,61568,45582,15986,0.259647869022869
11,2021-01-26,30866,24074,6792,0.22004794919976672
12,2021-01-27,14626,10190,4436,0.3032955011623137
13,2021-01-29,35877,27468,8409,0.23438414583159128
14,2021-01-30,23457,16378,7079,0.30178624717568314
15,2021-02-01,4242,3402,840,0.19801980198019803
16,2021-02-02,56215,41624,14591,0.25955705772480653
17,2021-02-04,92,74,18,0.1956521739130435
18,2021-02-05,65356,48251,17105,0.26172042352653163
19,2021-02-09,71017,52667,18350,0.25838883647577343
20,2021-02-12,73077,54424,18653,0.25525131026177866
21,2021-02-15,5381,4382,999,0.1856532243077495
22,2021-02-16,67118,49668,17450,0.25998986858964807
23,2021-02-18,7351,5852,1499,0.20391783430825738
24,2021-02-19,59489,43840,15649,0.2630570357545092
25,2021-02-22,888,714,174,0.19594594594594594
26,2021-02-23,62908,47106,15802,0.2511922172060787
27,2021-02-25,11111,9077,2034,0.1830618306183062
28,2021-02-26,50159,36655,13504,0.26922386809944376
29,2021-03-01,644,527,117,0.18167701863354038
30,2021-03-02,57104,43183,13921,0.24378327262538527
31,2021-03-18,41055,31089,9966,0.24274753379612715
32,2021-03-19,21617,15199,6418,0.29689596151177317
33,2021-03-23,58464,43529,14935,0.2554563492063492
34,2021-03-25,1293,1028,265,0.20494972931167826
35,2021-03-26,55280,41267,14013,0.2534913169319826
36,2021-03-30,54808,40983,13825,0.2522441979273099
37,2021-04-02,50091,37597,12494,0.24942604459883014
38,2021-04-06,49986,37821,12165,0.2433681430800624
39,2021-04-08,229,182,47,0.2052401746724891
40,2021-04-09,48046,35907,12139,0.2526537068642551
41,2021-04-12,2989,2432,557,0.18634994981599198
42,2021-04-13,41974,31710,10264,0.24453232953733264
43,2021-04-15,3572,2902,670,0.1875699888017917
44,2021-04-16,40170,30224,9946,0.24759770973363207
45,2021-04-19,4129,3343,786,0.1903608621942359
46,2021-04-20,52263,38697,13566,0.25957178118362895
47,2021-04-22,4842,3919,923,0.1906237092110698
48,2021-04-23,49520,36699,12821,0.25890549273021
49,2021-04-26,49778,38471,11307,0.22714853951544858
50,2021-04-27,28922,19173,9749,0.3370790401770279
51,2021-04-29,44421,34444,9977,0.2246009770153756
52,2021-04-30,26660,17540,9120,0.3420855213803451
53,2021-05-03,26628,21877,4751,0.1784212107555956
54,2021-05-04,1426,1027,399,0.27980364656381485
55,2021-05-06,20765,16506,4259,0.2051047435588731
56,2021-05-07,1390,901,489,0.35179856115107916
57,2021-05-10,20856,16274,4582,0.2196969696969697
58,2021-05-11,1701,1058,643,0.37801293356848914
59,2021-05-13,23650,18312,5338,0.22570824524312896
60,2021-05-14,450,290,160,0.35555555555555557
61,2021-05-17,23149,18776,4373,0.18890664823534495
62,2021-05-18,2255,1481,774,0.34323725055432375
63,2021-05-20,43879,33694,10185,0.23211559060142664
64,2021-05-21,26529,17469,9060,0.34151306117833313
65,2021-05-24,4356,3200,1156,0.26538108356290174
66,2021-05-25,16223,13508,2715,0.16735498982925476
67,2021-05-27,9400,6782,2618,0.2785106382978723
68,2021-05-28,21620,17101,4519,0.20901942645698426
69,2021-06-04,42315,32119,10196,0.24095474418055063
70,2021-06-07,20894,15281,5613,0.26864171532497366
71,2021-06-08,44348,34030,10318,0.23265987192207088
72,2021-06-10,22154,16405,5749,0.2595016701272908
73,2021-06-11,46322,35367,10955,0.23649669703380682
74,2021-06-14,17989,13400,4589,0.2551003390961143
75,2021-06-15,42337,31772,10565,0.2495453149727189
76,2021-06-17,13689,10119,3570,0.26079333771641466
77,2021-06-18,44352,33731,10621,0.23947059884559885
78,2021-06-21,16107,12172,3935,0.24430371887999006
79,2021-06-22,37293,29261,8032,0.21537553964550987
80,2021-06-24,18111,13336,4775,0.263651924244934
81,2021-06-25,40353,31615,8738,0.21653904294600154
82,2021-06-28,14105,10742,3363,0.23842609003899326
83,2021-06-29,42292,33007,9285,0.21954506762508275
84,2021-07-01,22127,16356,5771,0.2608125819134993
85,2021-07-02,42289,32442,9847,0.2328501501572513
86,2021-07-05,18116,13357,4759,0.26269595937293
87,2021-07-06,41387,32212,9175,0.22168796965230628
88,2021-07-07,1095,833,262,0.23926940639269406
89,2021-07-08,15597,11521,4076,0.2613323074950311
90,2021-07-09,41413,32413,9000,0.21732306280636515
91,2021-07-12,14091,10529,3562,0.25278546590022
92,2021-07-13,36347,27624,8723,0.2399922964756376
93,2021-07-15,16088,11856,4232,0.26305320735952264
94,2021-07-16,38209,30105,8104,0.21209662644926588
95,2021-07-19,18050,13282,4768,0.26415512465373964
96,2021-07-20,67,38,29,0.43283582089552236
97,2021-07-22,17376,12745,4631,0.2665170349907919
98,2021-07-23,35570,28231,7339,0.20632555524318247
99,2021-07-26,14076,9858,4218,0.29965899403239554
100,2021-07-27,34267,26794,7473,0.21808153617182713
101,2021-07-29,20125,14748,5377,0.2671801242236025
102,2021-07-30,42309,32457,9852,0.23285825710841665
103,2021-08-02,12096,8503,3593,0.2970403439153439
104,2021-08-03,36252,28455,7797,0.21507778881165177
105,2021-08-05,20113,14652,5461,0.271515934967434
106,2021-08-06,42321,32894,9427,0.22274993502043902
107,2021-08-09,18143,13318,4825,0.26594278785206416
108,2021-08-10,24217,19345,4872,0.20118098856175415
109,2021-08-12,16120,11797,4323,0.2681761786600496
110,2021-08-13,34330,26047,8283,0.24127585202446838
111,2021-08-16,14126,10510,3616,0.2559818773892114
112,2021-08-20,44973,35594,9379,0.2085473506326018
113,2021-08-21,7505,4998,2507,0.33404397068620917
114,2021-08-23,12086,8452,3634,0.3006784709581334
115,2021-08-24,38345,30172,8173,0.21314382579215022
116,2021-08-26,16136,11971,4165,0.2581184928111056
117,2021-08-27,33861,27021,6840,0.2020023035350403
118,2021-08-28,428,281,147,0.34345794392523366
119,2021-08-30,12098,9037,3061,0.2530170276078691
120,2021-08-31,33125,26615,6510,0.19652830188679246
121,2021-09-01,1157,751,406,0.3509075194468453
122,2021-09-03,32256,25340,6916,0.2144097222222222
123,2021-09-06,16092,11338,4754,0.2954262987820035
124,2021-09-07,44,26,18,0.4090909090909091
125,2021-09-10,36216,28689,7527,0.2078363154406892
126,2021-09-13,16111,11306,4805,0.2982434361616287
127,2021-09-14,39310,30713,8597,0.21869753243449505
128,2021-09-15,81,49,32,0.3950617283950617
129,2021-09-16,14760,11011,3749,0.2539972899728997
130,2021-09-17,37364,29556,7808,0.20897120222674231
131,2021-09-18,973,595,378,0.38848920863309355
132,2021-09-20,14112,10529,3583,0.25389739229024944
133,2021-09-21,33492,26140,7352,0.21951510808551297
134,2021-09-23,15498,11529,3969,0.25609756097560976
135,2021-09-24,39080,30642,8438,0.21591606960081883
136,2021-09-25,45,26,19,0.4222222222222222
137,2021-09-27,9817,7530,2287,0.2329632270551085
138,2021-09-28,38572,30217,8355,0.216607902105154
139,2021-09-30,14112,10458,3654,0.25892857142857145
140,2021-10-01,42336,32923,9413,0.22234032501889645
141,2021-10-04,15296,11362,3934,0.25719142259414224
142,2021-10-05,38285,30256,8029,0.2097165991902834
143,2021-10-07,14072,10521,3551,0.2523450824332007
144,2021-10-08,29686,22446,7240,0.24388600687192616
145,2021-10-11,16110,11927,4183,0.25965238981998756
146,2021-10-12,26,16,10,0.38461538461538464
147,2021-10-14,16128,11971,4157,0.25775049603174605
148,2021-10-15,46368,36224,10144,0.21877156659765357
149,2021-10-18,12114,8648,3466,0.2861152385669473
150,2021-10-19,41509,32419,9090,0.21898865306319112
151,2021-10-20,1404,882,522,0.3717948717948718
152,2021-10-21,18135,13292,4843,0.2670526606010477
153,2021-10-22,38285,29526,8759,0.22878411910669974
154,2021-10-25,16136,11986,4150,0.2571888943976202
155,2021-10-26,42670,33460,9210,0.21584251230372628
156,2021-10-27,16,10,6,0.375
157,2021-10-28,14258,10705,3553,0.24919343526441295
158,2021-10-29,32272,25446,6826,0.2115146256817055
159,2021-11-01,4036,2868,1168,0.2893954410307235
160,2021-11-02,31339,25376,5963,0.19027409936500844
161,2021-11-03,901,587,314,0.34850166481687017
162,2021-11-04,11306,8591,2715,0.2401379798337166
163,2021-11-05,22606,17963,4643,0.2053879501017429
164,2021-11-06,343,209,134,0.39067055393586003
165,2021-11-08,14084,10550,3534,0.25092303322919624
166,2021-11-11,16101,11943,4158,0.2582448295136948
167,2021-11-12,11,6,5,0.45454545454545453
168,2021-11-15,18126,13394,4732,0.2610614586781419
169,2021-11-18,18131,13395,4736,0.2612100821796922
170,2021-11-19,4,2,2,0.5
171,2021-11-22,17095,12722,4373,0.2558057911670079
172,2021-11-23,1040,656,384,0.36923076923076925
173,2021-11-25,17433,12910,4523,0.2594504675041588
174,2021-12-03,8163,6541,1622,0.1987014577973784
175,2021-12-04,7957,5879,2078,0.2611537011436471
176,2021-12-06,18135,15094,3041,0.1676867934932451
177,2021-12-07,30180,24343,5837,0.19340622929092113
178,2021-12-09,18106,15055,3051,0.1685076770131448
179,2021-12-10,28170,22991,5179,0.1838480653177139
180,2021-12-13,18126,15086,3040,0.16771488469601678
181,2021-12-14,36794,26289,10505,0.28550850682176443
182,2021-12-15,404,328,76,0.18811881188118812
183,2021-12-16,14246,10823,3423,0.24027797276428473
184,2021-12-17,32345,23109,9236,0.28554645231102177
185,2021-12-19,1037,872,165,0.15911282545805208
186,2021-12-20,13408,10567,2841,0.2118884248210024
187,2021-12-21,30926,22136,8790,0.28422686412727155
188,2021-12-22,713,619,94,0.13183730715287517
189,2021-12-23,11574,9268,2306,0.19923967513392085
190,2021-12-24,29177,20930,8247,0.28265414538849093
191,2021-12-26,420,360,60,0.14285714285714285
192,2021-12-27,7754,6097,1657,0.21369615682228527
193,2021-12-28,31123,22205,8918,0.2865405005944157
194,2021-12-29,708,611,97,0.1370056497175141
195,2021-12-30,10903,8837,2066,0.18948913143171603
196,2021-12-31,30373,21330,9043,0.2977315378790373
197,2022-01-03,14508,11487,3021,0.20822994210090984
198,2022-01-04,31447,22422,9025,0.286990809934175
199,2022-01-05,574,474,100,0.17421602787456447
200,2022-01-06,7905,6128,1777,0.2247944339025933
201,2022-01-07,22983,16249,6734,0.2929991733020058
202,2022-01-10,10075,8287,1788,0.17746898263027294
203,2022-01-12,221,181,40,0.18099547511312217
204,2022-01-13,5824,4055,1769,0.30374313186813184
205,2022-01-14,34163,24309,9854,0.2884407107104177
206,2022-01-15,1697,1078,619,0.36476134354743667
207,2022-01-16,1160,963,197,0.16982758620689656
208,2022-01-17,12577,9963,2614,0.2078397074024012
209,2022-01-18,34203,24365,9838,0.28763558752156243
210,2022-01-19,492,349,143,0.29065040650406504
211,2022-01-20,10916,7757,3159,0.28939171857823376
212,2022-01-21,34646,24451,10195,0.29426196386307224
213,2022-01-23,735,580,155,0.2108843537414966
214,2022-01-24,9039,6865,2174,0.2405133311206992
215,2022-01-25,34464,24347,10117,0.29355269266480966
216,2022-01-26,756,602,154,0.2037037037037037
217,2022-01-27,12643,9397,3246,0.2567428616625801
218,2022-01-28,34833,24435,10398,0.29851003358883815
219,2022-01-30,620,515,105,0.1693548387096774
220,2022-01-31,8794,6694,2100,0.23879918125994998
221,2022-02-01,31075,21859,9216,0.2965728077232502
222,2022-02-02,636,587,49,0.0770440251572327
223,2022-02-03,8264,6780,1484,0.17957405614714425
224,2022-02-04,34611,24506,10105,0.29195920372136025
225,2022-02-06,825,707,118,0.14303030303030304
226,2022-02-07,11878,9431,2447,0.2060111129819835
227,2022-02-08,33311,23638,9673,0.2903845576536279
228,2022-02-09,262,220,42,0.16030534351145037
229,2022-02-10,7847,6094,1753,0.22339747674270422
230,2022-02-11,29615,20938,8677,0.29299341549890257
231,2022-02-13,834,730,104,0.12470023980815348
232,2022-02-14,9697,7845,1852,0.19098690316592762
233,2022-02-15,31385,22184,9201,0.2931655249322925
234,2022-02-16,1077,883,194,0.18012999071494892
235,2022-02-17,11019,8811,2208,0.20038115981486523
236,2022-02-18,19257,14427,4830,0.25081788440567065
237,2022-02-19,13451,8650,4801,0.3569251356776448
238,2022-02-20,568,458,110,0.1936619718309859
239,2022-02-21,9960,7525,2435,0.24447791164658633
240,2022-02-22,29723,21102,8621,0.29004474649261514
241,2022-02-23,609,504,105,0.1724137931034483
242,2022-02-24,16060,12489,3571,0.22235367372353673
243,2022-02-25,31652,22320,9332,0.29483129028181476
244,2022-02-26,111,68,43,0.38738738738738737
245,2022-02-28,13167,10072,3095,0.23505734032049821
246,2022-03-01,32267,21726,10541,0.3266805094988688
247,2022-03-02,278,201,77,0.27697841726618705
248,2022-03-03,15850,12125,3725,0.23501577287066247
249,2022-03-04,11546,7959,3587,0.3106703620301403
250,2022-03-06,77,49,28,0.36363636363636365
251,2022-03-07,14370,9749,4621,0.32157272094641615
252,2022-03-08,28821,19711,9110,0.31608896290898997
253,2022-03-09,116,71,45,0.3879310344827586
254,2022-03-10,8913,6152,2761,0.30977224279142823
255,2022-03-11,28161,19342,8819,0.3131635950427897
256,2022-03-14,14082,9631,4451,0.316077261752592
257,2022-03-15,30359,20695,9664,0.31832405546954773
258,2022-03-16,942,642,300,0.3184713375796178
259,2022-03-17,13156,9165,3991,0.30335968379446643
260,2022-03-20,385,261,124,0.3220779220779221
261,2022-03-21,12858,8799,4059,0.31567895473635094
262,2022-03-22,29669,20069,9600,0.3235700562877077
263,2022-03-23,201,136,65,0.32338308457711445
264,2022-03-24,6779,4687,2092,0.3086000885086296
265,2022-03-25,23230,15860,7370,0.3172621609987086
266,2022-03-28,765,476,289,0.37777777777777777
267,2022-03-29,23415,15979,7436,0.31757420456972024
268,2022-03-30,237,167,70,0.29535864978902954
269,2022-03-31,6266,4297,1969,0.3142355569741462
270,2022-04-01,25737,17583,8154,0.31682014220771654
271,2022-04-03,235,161,74,0.3148936170212766
272,2022-04-04,5426,3745,1681,0.3098046443051972
273,2022-04-05,25455,17289,8166,0.32080141426045966
274,2022-04-06,172,106,66,0.38372093023255816
275,2022-04-07,6531,4590,1941,0.2971979788700046
276,2022-04-08,25712,17507,8205,0.3191116988176727
277,2022-04-10,273,224,49,0.1794871794871795
278,2022-04-11,6841,4853,1988,0.29060078935828093
279,2022-04-12,23096,15581,7515,0.32538101835815725
280,2022-04-13,125,77,48,0.384
281,2022-04-14,8372,5836,2536,0.3029144768275203
282,2022-04-15,23711,16195,7516,0.3169836784614736
283,2022-04-17,612,395,217,0.3545751633986928
284,2022-04-18,9112,6085,3027,0.33219929762949957
285,2022-04-19,24548,16609,7939,0.3234072022160665
286,2022-04-20,354,232,122,0.3446327683615819
287,2022-04-21,7929,5430,2499,0.31517215285660233
288,2022-04-22,23925,16396,7529,0.3146917450365726
289,2022-04-24,95,68,27,0.28421052631578947
290,2022-04-25,1919,1346,573,0.2985930171964565
291,2022-04-26,2011,1432,579,0.28791645947289907
292,2022-04-27,457,330,127,0.2778993435448578
293,2022-04-28,2082,1420,662,0.31796349663784823
294,2022-04-29,15667,11118,4549,0.29035552435054574
295,2022-04-30,13507,8811,4696,0.3476715777004516
296,2022-05-02,7739,5195,2544,0.3287246414265409
297,2022-05-03,27812,18802,9010,0.32396088019559904
298,2022-05-04,459,293,166,0.3616557734204793
299,2022-05-05,11898,8054,3844,0.32307950916120354
300,2022-05-06,29116,19648,9468,0.3251820304986949
301,2022-05-09,2014,1561,453,0.22492552135054616
302,2022-05-10,2010,1409,601,0.2990049751243781
303,2022-05-12,2010,1571,439,0.21840796019900496
304,2022-05-13,2010,1426,584,0.29054726368159206
305,2022-05-16,1570,1269,301,0.19171974522292995
306,2022-05-17,2438,1807,631,0.25881870385561934
307,2022-05-19,2003,1589,414,0.20668996505242138
308,2022-05-20,2003,1471,532,0.2656015976035946
309,2022-05-23,2003,1608,395,0.19720419370943584
310,2022-05-24,3181,2327,854,0.2684690348946872
311,2022-05-26,2003,1625,378,0.18871692461308037
312,2022-05-27,2003,1471,532,0.2656015976035946
313,2022-05-30,2003,1581,422,0.2106839740389416
314,2022-05-31,2003,1470,533,0.26610084872690964
315,2022-06-02,2003,1592,411,0.20519221168247628
316,2022-06-03,2003,1472,531,0.2651023464802796
317,2022-06-06,892,741,151,0.16928251121076232
318,2022-06-10,2003,1472,531,0.2651023464802796
319,2022-06-14,2003,1484,519,0.25911133300049927
320,2022-06-17,2003,1487,516,0.25761357963055415
321,2022-06-21,2002,1487,515,0.25724275724275725
322,2022-06-24,2002,1490,512,0.25574425574425574
323,2022-06-28,2017,1501,516,0.255825483391175
324,2022-07-01,2017,1501,516,0.255825483391175
325,2022-07-05,2019,1507,512,0.2535908865775136
326,2022-07-07,345,282,63,0.1826086956521739
327,2022-07-08,1674,1226,448,0.26762246117084826
328,2022-07-15,2019,1508,511,0.2530955918771669
329,2022-07-18,344,282,62,0.18023255813953487
330,2022-07-19,1675,1218,457,0.2728358208955224
331,2022-07-21,345,283,62,0.17971014492753623
332,2022-07-22,1674,1224,450,0.26881720430107525
333,2022-07-25,345,283,62,0.17971014492753623
334,2022-07-26,1674,1223,451,0.2694145758661888
335,2022-07-28,286,234,52,0.18181818181818182
336,2022-07-29,1733,1274,459,0.26485862665897286
337,2022-08-01,359,293,66,0.18384401114206128
338,2022-08-02,1454,1062,392,0.2696011004126547
339,2022-08-08,347,288,59,0.17002881844380405
340,2022-08-09,1672,1221,451,0.26973684210526316
341,2022-08-11,346,286,60,0.17341040462427745
342,2022-08-12,1674,1222,452,0.27001194743130225
343,2022-08-15,361,297,64,0.1772853185595568
344,2022-08-16,1659,1211,448,0.270042194092827
345,2022-08-18,373,304,69,0.18498659517426275
346,2022-08-19,1647,1203,444,0.26958105646630237
347,2022-08-22,272,222,50,0.18382352941176472
348,2022-08-23,1748,1284,464,0.2654462242562929
349,2022-08-26,2020,1505,515,0.25495049504950495
350,2022-09-12,319,267,52,0.16300940438871472
351,2022-09-13,1703,1244,459,0.26952436876101
352,2022-09-15,289,241,48,0.16608996539792387
353,2022-09-16,1729,1262,467,0.2700983227299017
354,2022-09-22,194,148,46,0.23711340206185566
355,2022-09-23,1824,1341,483,0.26480263157894735
356,2022-09-26,293,229,64,0.21843003412969283
357,2022-09-27,1727,1259,468,0.2709901563404748
358,2022-09-29,296,232,64,0.21621621621621623
359,2022-09-30,1723,1255,468,0.2716192687173535
360,2022-10-03,209,162,47,0.22488038277511962
361,2022-10-04,1809,1305,504,0.27860696517412936
362,2022-10-06,237,184,53,0.22362869198312235
363,2022-10-07,1781,1288,493,0.2768107804604155
364,2022-10-10,208,159,49,0.23557692307692307
365,2022-10-11,1810,1311,499,0.27569060773480664
366,2022-10-13,9103,6612,2491,0.2736460507524992
367,2022-10-14,23904,16818,7086,0.2964357429718876
368,2022-10-19,468,348,120,0.2564102564102564
369,2022-10-20,7876,5666,2210,0.28059928897917724
370,2022-10-21,25962,18297,7665,0.29523919574763113
371,2022-10-23,577,437,140,0.24263431542461006
372,2022-10-24,8073,5764,2309,0.28601511210206865
373,2022-10-25,22154,15401,6753,0.30482079985555655
374,2022-10-27,9281,6842,2439,0.26279495743993103
375,2022-10-28,19229,13812,5417,0.28170991731239275
376,2022-10-30,603,446,157,0.2603648424543947
377,2022-10-31,8878,6461,2417,0.2722460013516558
378,2022-11-01,24156,17239,6917,0.2863470773306839
379,2022-11-03,11981,8961,3020,0.2520657708037726
380,2022-11-04,22342,16091,6251,0.2797869483484021
381,2022-11-06,1015,798,217,0.21379310344827587
382,2022-11-07,9690,7328,2362,0.2437564499484004
383,2022-11-08,25673,18394,7279,0.28352744128072294
384,2022-11-09,561,420,141,0.25133689839572193
385,2022-11-10,7422,5482,1940,0.26138507140932365
386,2022-11-11,21535,15868,5667,0.263153006733225
387,2022-11-13,742,578,164,0.2210242587601078
388,2022-11-14,10077,7525,2552,0.2532499751910291
389,2022-11-15,16721,11796,4925,0.29453980025118115
390,2022-11-16,526,405,121,0.2300380228136882
391,2022-11-17,8522,6363,2159,0.253344285379019
392,2022-11-18,27330,19904,7426,0.27171606293450423
393,2022-11-20,696,546,150,0.21551724137931033
394,2022-11-21,9615,7346,2269,0.23598543941757671
395,2022-11-22,21087,15333,5754,0.27286954047517425
396,2022-11-23,435,329,106,0.24367816091954023
397,2022-11-24,7777,5780,1997,0.25678282113925677
398,2022-11-25,26162,19305,6857,0.2620976989526795
399,2022-11-27,151,119,32,0.2119205298013245
400,2022-11-28,6053,4517,1536,0.2537584668759293
401,2022-11-29,15777,11704,4073,0.25816061355137226
402,2022-11-30,140,107,33,0.2357142857142857
403,2022-12-01,7945,5908,2037,0.2563876651982379
404,2022-12-02,22230,16397,5833,0.2623931623931624
405,2022-12-04,269,208,61,0.22676579925650558
406,2022-12-05,8114,6038,2076,0.25585407936899185
407,2022-12-06,21932,16101,5831,0.2658672259711837
408,2022-12-07,306,238,68,0.2222222222222222
409,2022-12-08,7464,5515,1949,0.26112004287245444
410,2022-12-09,18503,13755,4748,0.2566070366967519
411,2022-12-11,312,243,69,0.22115384615384615
412,2022-12-12,8082,5989,2093,0.25897055184360307
413,2022-12-13,21936,16100,5836,0.2660466812545587
414,2022-12-14,313,244,69,0.22044728434504793
415,2022-12-15,8071,5985,2086,0.25845620121422375
416,2022-12-16,18500,13703,4797,0.2592972972972973
417,2022-12-19,8224,6093,2131,0.2591196498054475
418,2022-12-20,23563,17373,6190,0.26269999575605824
419,2022-12-21,319,255,64,0.2006269592476489
420,2022-12-22,7928,5895,2033,0.25643289606458125
421,2022-12-23,22098,16286,5812,0.26301022716987965
422,2022-12-25,196,156,40,0.20408163265306123
423,2022-12-26,5857,4372,1485,0.25354276933583747
424,2022-12-27,20884,15470,5414,0.2592415246121433
425,2022-12-29,6069,4437,1632,0.2689075630252101
426,2022-12-30,22673,16874,5799,0.25576677104926565
427,2023-01-01,669,512,157,0.23467862481315396
428,2023-01-02,8977,6573,2404,0.2677954773309569
429,2023-01-03,18676,13943,4733,0.25342685799957165
430,2023-01-04,625,476,149,0.2384
431,2023-01-05,9209,6754,2455,0.2665870344228472
432,2023-01-06,20511,15291,5220,0.2544975866608161
433,2023-01-08,289,218,71,0.24567474048442905
434,2023-01-09,6385,4741,1644,0.2574784651527016
435,2023-01-10,23118,17222,5896,0.25503936326671856
436,2023-01-11,177,142,35,0.1977401129943503
437,2023-01-12,7812,5585,2227,0.2850742447516641
438,2023-01-13,22380,16722,5658,0.25281501340482576
439,2023-01-16,9175,6612,2563,0.27934604904632154
440,2023-01-17,22083,16365,5718,0.2589322102975139
441,2023-01-18,247,192,55,0.22267206477732793
442,2023-01-19,8345,6058,2287,0.27405632115038947
443,2023-01-20,21925,16397,5528,0.25213226909920183
444,2023-01-22,262,219,43,0.16412213740458015
445,2023-01-23,10858,8515,2343,0.21578559587400994
446,2023-01-24,22245,16420,5825,0.2618565969880872
447,2023-01-25,266,223,43,0.16165413533834586
448,2023-01-26,10806,8446,2360,0.2183971867481029
449,2023-01-27,22011,16126,5885,0.2673663168415792
450,2023-01-30,13255,10269,2986,0.225273481705017
451,2023-01-31,18566,13946,4620,0.2488419691909943
452,2023-02-01,455,364,91,0.2
453,2023-02-02,10131,7349,2782,0.2746027045701313
454,2023-02-03,20622,15328,5294,0.2567161284065561
455,2023-02-05,120,90,30,0.25
456,2023-02-06,7326,5485,1841,0.2512967512967513
457,2023-02-07,23804,17610,6194,0.2602083683414552
458,2023-02-08,207,168,39,0.18840579710144928
459,2023-02-09,7055,5239,1816,0.25740609496810773
460,2023-02-10,23949,17667,6282,0.26230740323186774
461,2023-02-13,10710,8411,2299,0.21465919701213818
462,2023-02-14,32484,23501,8983,0.2765361408693511
463,2023-02-15,700,571,129,0.18428571428571427
464,2023-02-16,9711,7538,2173,0.2237668623210792
465,2023-02-17,26961,20179,6782,0.25154853306628094
466,2023-02-20,10053,8038,2015,0.20043768029443948
467,2023-02-21,29151,22041,7110,0.24390243902439024
468,2023-02-22,390,337,53,0.1358974358974359
469,2023-02-23,9208,7309,1899,0.20623370981754996
470,2023-02-24,26531,19871,6660,0.2510271003731484
471,2023-02-26,411,353,58,0.1411192214111922
472,2023-02-27,7528,5976,1552,0.206163655685441
473,2023-02-28,27538,20875,6663,0.24195656910451013
474,2023-03-01,532,457,75,0.14097744360902256
475,2023-03-02,7965,6285,1680,0.21092278719397364
476,2023-03-03,19046,14739,4307,0.22613672162133783
477,2023-03-04,5674,4074,1600,0.28198801550934083
478,2023-03-05,457,392,65,0.1422319474835886
479,2023-03-06,8992,7080,1912,0.21263345195729538
480,2023-03-07,24489,18693,5796,0.2366776920249908
481,2023-03-09,8397,6822,1575,0.18756698821007503
482,2023-03-10,24415,18386,6029,0.24693835756706942
483,2023-03-13,10326,8257,2069,0.20036800309897346
484,2023-03-14,25324,19115,6209,0.24518243563418102
485,2023-03-15,387,337,50,0.12919896640826872
486,2023-03-16,7705,6126,1579,0.20493186242699546
487,2023-03-17,24720,18649,6071,0.2455906148867314
488,2023-03-19,619,519,100,0.16155088852988692
489,2023-03-20,8848,6979,1869,0.21123417721518986
490,2023-03-21,25597,19332,6265,0.24475524475524477
491,2023-03-22,618,517,101,0.1634304207119741
492,2023-03-23,7894,6272,1622,0.20547251076767165
493,2023-03-24,24720,18650,6070,0.24555016181229775
494,2023-03-26,483,416,67,0.13871635610766045
495,2023-03-27,10172,8084,2088,0.2052693668895006
496,2023-03-28,24817,18607,6210,0.25023169601482853
497,2023-03-29,484,417,67,0.1384297520661157
498,2023-03-30,9317,7465,1852,0.19877643018138885
499,2023-03-31,23401,17532,5869,0.25080124780992263
