,date,measurements,ok,anomalies,ratio
0,2021-01-01,960399,955251,5148,0.005360272136893104
1,2021-01-04,284813,283409,1404,0.004929550266315091
2,2021-01-05,998475,993202,5273,0.005281053606750294
3,2021-01-07,295972,294132,1840,0.0062168042922979205
4,2021-01-08,993815,986930,6885,0.0069278487444846375
5,2021-01-11,960047,955568,4479,0.004665396589958616
6,2021-01-12,277836,276189,1647,0.005927957500107978
7,2021-01-14,4460,4451,9,0.002017937219730942
8,2021-01-15,27796,27742,54,0.0019427255720247517
9,2021-01-18,275714,274363,1351,0.004900005077725469
10,2021-01-19,956183,951229,4954,0.0051810166045620975
11,2021-01-21,290931,289508,1423,0.004891194131941938
12,2021-01-22,956844,951845,4999,0.005224467102265364
13,2021-01-25,856166,851628,4538,0.005300373992893901
14,2021-01-26,299543,297722,1821,0.006079260740528071
15,2021-01-28,852370,847295,5075,0.005953987118270235
16,2021-01-29,133225,132332,893,0.006702946143741791
17,2021-02-01,279470,278069,1401,0.005013060435824954
18,2021-02-02,864386,860075,4311,0.004987355186224673
19,2021-02-04,287589,286305,1284,0.0044647048391976045
20,2021-02-05,877153,872946,4207,0.004796198610732677
21,2021-02-08,309154,307559,1595,0.005159241025508323
22,2021-02-09,922151,916837,5314,0.005762613715107396
23,2021-02-11,315088,313299,1789,0.005677778906210329
24,2021-02-12,904073,899143,4930,0.0054530994731620125
25,2021-02-15,292854,291223,1631,0.005569328061081631
26,2021-02-16,858452,853757,4695,0.005469146789803041
27,2021-02-18,286499,284586,1913,0.006677161176827842
28,2021-02-19,931823,925851,5972,0.006408942470834053
29,2021-02-22,310975,309053,1922,0.006180561138355173
30,2021-02-23,953457,947524,5933,0.0062226193735008505
31,2021-02-25,332556,330272,2284,0.006868016213810607
32,2021-02-26,908857,902954,5903,0.006494971156078459
33,2021-03-01,285226,283391,1835,0.0064334948426861506
34,2021-03-02,935196,929399,5797,0.006198700593244625
35,2021-03-18,242339,241093,1246,0.005141557900296692
36,2021-03-19,1018968,1014416,4552,0.004467264919016102
37,2021-03-22,179848,179031,817,0.004542724967750545
38,2021-03-23,1017333,1012838,4495,0.004418415602364221
39,2021-03-25,205420,203839,1581,0.007696426832830299
40,2021-03-26,917015,901319,15696,0.017116404857063408
41,2021-03-29,188050,186720,1330,0.007072587077904813
42,2021-03-30,940764,934326,6438,0.0068433741087031395
43,2021-04-02,12090,11993,97,0.008023159636062862
44,2021-04-05,180047,178971,1076,0.005976217321032842
45,2021-04-06,988694,982861,5833,0.005899702031164344
46,2021-04-08,186106,184877,1229,0.006603763446637938
47,2021-04-09,963275,956940,6335,0.006576522799823519
48,2021-04-12,177445,176214,1231,0.006937360872382992
49,2021-04-13,947031,940953,6078,0.0064179525274251845
50,2021-04-15,194611,193337,1274,0.006546392547183869
51,2021-04-16,936047,930515,5532,0.005909959649462046
52,2021-04-19,1112014,1105145,6869,0.006177080504382139
53,2021-04-20,25955,25468,487,0.01876324407628588
54,2021-04-22,181766,180281,1485,0.008169844745441942
55,2021-04-23,1042274,1034275,7999,0.00767456542137672
56,2021-04-26,1244556,1237161,7395,0.0059418780673589616
57,2021-04-27,165,156,9,0.05454545454545454
58,2021-04-29,1196770,1189389,7381,0.006167434009876584
59,2021-04-30,135,128,7,0.05185185185185185
60,2021-05-03,1236397,1229086,7311,0.005913149255457592
61,2021-05-06,1218805,1211201,7604,0.006238897936913616
62,2021-05-09,390003,387786,2217,0.005684571657141099
63,2021-05-10,464750,461483,3267,0.007029585798816568
64,2021-05-13,1245210,1237569,7641,0.006136314356614547
65,2021-05-17,1232715,1224794,7921,0.0064256539427199316
66,2021-05-20,1232409,1224580,7829,0.006352598853140475
67,2021-05-24,581961,577835,4126,0.007089822170214155
68,2021-05-25,601534,597861,3673,0.006106055518058829
69,2021-05-27,602974,598719,4255,0.0070566890114664976
70,2021-05-28,599347,595624,3723,0.006211760465973801
71,2021-06-04,638550,634734,3816,0.005976039464411558
72,2021-06-07,692431,687334,5097,0.007361022253480852
73,2021-06-08,690514,685844,4670,0.006763077939042511
74,2021-06-10,661120,655870,5250,0.007941069699903195
75,2021-06-11,613201,609077,4124,0.006725364113887616
76,2021-06-14,570803,566367,4436,0.007771507858227795
77,2021-06-15,601510,597423,4087,0.006794567006367309
78,2021-06-17,585989,581132,4857,0.0082885514915809
79,2021-06-18,529909,525533,4376,0.00825802166032281
80,2021-06-21,526417,521845,4572,0.008685129849529936
81,2021-06-22,616541,612438,4103,0.006654869668035053
82,2021-06-24,564308,560569,3739,0.006625814271638893
83,2021-06-25,610477,606669,3808,0.006237745238559356
84,2021-06-28,572040,567789,4251,0.007431298510593665
85,2021-06-29,596484,592549,3935,0.00659699170472301
86,2021-07-01,594616,590801,3815,0.006415905391042286
87,2021-07-02,629259,625291,3968,0.006305829555079864
88,2021-07-05,568720,564813,3907,0.006869812913208609
89,2021-07-06,649282,645301,3981,0.0061313882103615994
90,2021-07-07,56045,55664,381,0.006798108662681774
91,2021-07-08,569935,565463,4472,0.007846508812408432
92,2021-07-09,610829,606635,4194,0.0068660787225229974
93,2021-07-12,571136,566844,4292,0.00751484760197221
94,2021-07-13,605464,601335,4129,0.006819563177992416
95,2021-07-15,596220,591855,4365,0.007321123075374861
96,2021-07-16,554253,549965,4288,0.007736539089549357
97,2021-07-19,559330,555167,4163,0.007442833389948688
98,2021-07-22,609202,604880,4322,0.007094526938519571
99,2021-07-23,631387,626292,5095,0.008069535799755142
100,2021-07-26,542114,538157,3957,0.0072992027507129496
101,2021-07-27,565415,561553,3862,0.006830381224410389
102,2021-07-29,602556,597958,4598,0.007630826014511515
103,2021-07-30,564684,560214,4470,0.007915931742355017
104,2021-08-02,524054,520387,3667,0.0069973704999866425
105,2021-08-03,598174,594272,3902,0.006523185561391836
106,2021-08-05,602684,598028,4656,0.007725441524911894
107,2021-08-06,649163,644462,4701,0.007241632687013893
108,2021-08-09,588199,583654,4545,0.00772697675446575
109,2021-08-10,526251,522602,3649,0.006933953569684428
110,2021-08-12,494087,490935,3152,0.006379443296423504
111,2021-08-13,599805,595609,4196,0.006995606905577646
112,2021-08-16,513862,509556,4306,0.00837968170442648
113,2021-08-20,1039531,1032428,7103,0.006832889062471441
114,2021-08-21,89141,88329,812,0.009109164133227135
115,2021-08-23,536876,533215,3661,0.006819079265975756
116,2021-08-24,618838,614821,4017,0.006491198019513992
117,2021-08-26,559265,555380,3885,0.006946617435383941
118,2021-08-27,575459,571047,4412,0.007666923273421738
119,2021-08-30,545585,541659,3926,0.0071959456363353096
120,2021-08-31,488644,485083,3561,0.007287514018385573
121,2021-09-03,543054,539808,3246,0.005977306124252837
122,2021-09-06,556291,553237,3054,0.005489932427452538
123,2021-09-10,571860,568491,3369,0.005891302066939461
124,2021-09-13,535910,532371,3539,0.006603720774010562
125,2021-09-14,595096,590885,4211,0.007076169223116943
126,2021-09-16,602104,598875,3229,0.005362860901106785
127,2021-09-17,564206,561700,2506,0.004441640110172526
128,2021-09-20,589068,585351,3717,0.0063099676098514945
129,2021-09-21,589841,586523,3318,0.005625244769353097
130,2021-09-23,533067,530469,2598,0.00487368379584555
131,2021-09-24,621363,618436,2927,0.004710611993311478
132,2021-09-27,482999,480759,2240,0.004637690761264516
133,2021-09-28,608937,606027,2910,0.004778819483788963
134,2021-09-30,530255,527926,2329,0.004392226381646566
135,2021-10-01,626752,623967,2785,0.004443543857857653
136,2021-10-04,562538,559021,3517,0.006252022085619105
137,2021-10-05,607191,603766,3425,0.005640729193943915
138,2021-10-07,559697,556617,3080,0.005502977503899431
139,2021-10-08,586542,583700,2842,0.004845347818229556
140,2021-10-11,561504,558407,3097,0.005515543967629794
141,2021-10-14,530201,526440,3761,0.0070935362249411075
142,2021-10-15,623632,620924,2708,0.004342304435949406
143,2021-10-18,519685,517031,2654,0.005106939780828771
144,2021-10-19,623039,619702,3337,0.005356005001292054
145,2021-10-21,570536,567708,2828,0.004956742431678282
146,2021-10-22,543073,540535,2538,0.00467340486453939
147,2021-10-25,545763,543348,2415,0.004424997663821109
148,2021-10-26,637914,635204,2710,0.0042482215471050955
149,2021-10-28,573350,570346,3004,0.005239382576087905
150,2021-10-29,568364,565878,2486,0.004373957534256216
151,2021-11-01,585979,583000,2979,0.005083799931396859
152,2021-11-02,599128,596169,2959,0.004938844453939726
153,2021-11-04,534029,532063,1966,0.0036814480112503252
154,2021-11-05,575289,572735,2554,0.004439507795212494
155,2021-11-08,552624,548728,3896,0.007050001447638901
156,2021-11-11,510410,508572,1838,0.003601026625653886
157,2021-11-15,527461,525098,2363,0.004479952072285913
158,2021-11-18,570946,568615,2331,0.004082697838324465
159,2021-11-22,571560,568842,2718,0.0047554062565609906
160,2021-11-25,592987,590688,2299,0.0038769821260837083
161,2021-12-03,402947,401572,1375,0.0034123594418124467
162,2021-12-04,167170,166412,758,0.004534306394688042
163,2021-12-06,561645,559083,2562,0.004561600299121331
164,2021-12-07,599404,596450,2954,0.004928228707182468
165,2021-12-09,552089,549716,2373,0.004298220033364186
166,2021-12-10,537808,535033,2775,0.005159833992800404
167,2021-12-13,567495,564292,3203,0.005644102591212258
168,2021-12-14,475583,473693,1890,0.003974069720742751
169,2021-12-15,23597,23500,97,0.004110692037123363
170,2021-12-16,583667,580346,3321,0.005689888241068966
171,2021-12-17,445182,442146,3036,0.00681968273649878
172,2021-12-19,64596,64268,328,0.005077713790327574
173,2021-12-20,547240,544429,2811,0.005136685914772312
174,2021-12-21,432950,431080,1870,0.004319205450975863
175,2021-12-22,48675,48418,257,0.005279917822290704
176,2021-12-23,544571,541797,2774,0.005093917964783288
177,2021-12-24,428903,427117,1786,0.004164111698915606
178,2021-12-26,34374,34129,245,0.007127480072147553
179,2021-12-27,392432,389940,2492,0.0063501447384515025
180,2021-12-28,436902,434962,1940,0.004440355045296199
181,2021-12-29,43083,42878,205,0.0047582573172713135
182,2021-12-30,468519,466327,2192,0.004678572267079884
183,2021-12-31,453707,451861,1846,0.004068705133489234
184,2022-01-03,674376,671104,3272,0.004851892712670676
185,2022-01-04,431974,430200,1774,0.004106728645705529
186,2022-01-05,69130,68848,282,0.0040792709388109355
187,2022-01-06,529525,527195,2330,0.004400169963646665
188,2022-01-07,401768,399862,1906,0.004744031381294677
189,2022-01-10,449134,447227,1907,0.004245948870492993
190,2022-01-12,24876,24833,43,0.0017285737256793696
191,2022-01-13,464687,462654,2033,0.004374987895077762
192,2022-01-14,482728,480542,2186,0.0045284300889942165
193,2022-01-16,66040,65644,396,0.005996365838885524
194,2022-01-17,503536,500737,2799,0.0055586889517333414
195,2022-01-18,408384,406461,1923,0.004708803479078514
196,2022-01-19,56301,56005,296,0.005257455462602796
197,2022-01-20,586194,583321,2873,0.0049011078243721366
198,2022-01-21,423296,421283,2013,0.004755537496220139
199,2022-01-23,63942,63647,295,0.0046135560351568605
200,2022-01-24,487974,485497,2477,0.0050760901195555505
201,2022-01-25,414054,412385,1669,0.004030875199853159
202,2022-01-26,61384,61082,302,0.004919848820539554
203,2022-01-27,582606,579758,2848,0.004888380826836661
204,2022-01-28,417396,414786,2610,0.006253054653135152
205,2022-01-30,71665,71358,307,0.004283820553966372
206,2022-01-31,516155,513744,2411,0.004671077486413965
207,2022-02-01,422842,420642,2200,0.005202889022377153
208,2022-02-02,64863,64591,272,0.004193453895132818
209,2022-02-03,519541,517014,2527,0.004863908719427341
210,2022-02-04,408237,405908,2329,0.005705019388247513
211,2022-02-06,56802,56593,209,0.0036794479067638465
212,2022-02-07,528538,526260,2278,0.004310002308254089
213,2022-02-08,425176,422815,2361,0.005552994524620393
214,2022-02-09,34373,34314,59,0.0017164635033311028
215,2022-02-10,602231,598816,3415,0.005670581554254098
216,2022-02-11,439058,436538,2520,0.005739560604749259
217,2022-02-13,69805,69542,263,0.0037676384213165244
218,2022-02-14,517626,515226,2400,0.004636552259739657
219,2022-02-15,430664,428048,2616,0.00607434101759144
220,2022-02-16,75025,74629,396,0.005278240586471176
221,2022-02-17,539602,536587,3015,0.005587451492025604
222,2022-02-18,421527,419402,2125,0.005041195463161316
223,2022-02-19,59204,58831,373,0.006300249983109249
224,2022-02-20,52635,52416,219,0.0041607295525790825
225,2022-02-21,511388,501027,10361,0.020260545808661917
226,2022-02-22,431035,428606,2429,0.005635273237672115
227,2022-02-23,32735,32628,107,0.003268672674507408
228,2022-02-24,545220,540617,4603,0.008442463592678185
229,2022-02-25,426053,424036,2017,0.004734152793197091
230,2022-02-28,551783,547737,4046,0.0073325927040158905
231,2022-03-01,453771,451065,2706,0.005963360373404206
232,2022-03-02,14676,14618,58,0.003952030526028891
233,2022-03-03,577644,573117,4527,0.00783700687620749
234,2022-03-04,400989,398782,2207,0.005503891627949894
235,2022-03-06,4858,4830,28,0.005763688760806916
236,2022-03-07,505673,502223,3450,0.006822590883832041
237,2022-03-08,397234,394609,2625,0.006608195673079344
238,2022-03-09,12230,12221,9,0.0007358953393295176
239,2022-03-10,477386,474530,2856,0.00598258013431479
240,2022-03-11,371706,369431,2275,0.006120428510704697
241,2022-03-14,441440,438638,2802,0.006347408481333816
242,2022-03-15,406267,403549,2718,0.006690181580093879
243,2022-03-16,40352,40195,157,0.003890761300555115
244,2022-03-17,335416,333657,1759,0.005244234025806759
245,2022-03-20,23124,23061,63,0.0027244421380384016
246,2022-03-21,462904,459978,2926,0.006320965038107253
247,2022-03-22,363250,361066,2184,0.006012388162422574
248,2022-03-23,21718,21640,78,0.003591490929183166
249,2022-03-24,438452,435900,2552,0.005820477498106977
250,2022-03-25,368115,366186,1929,0.005240210260380587
251,2022-03-28,21119,21058,61,0.002888394336853071
252,2022-03-29,365150,363380,1770,0.004847323017937834
253,2022-03-30,27040,26931,109,0.004031065088757397
254,2022-03-31,445502,442144,3358,0.007537564365592074
255,2022-04-01,371155,368974,2181,0.005876251161913486
256,2022-04-03,28071,27955,116,0.004132378611378291
257,2022-04-04,469281,466370,2911,0.006203106454341855
258,2022-04-05,359548,357776,1772,0.004928410114922069
259,2022-04-06,13449,13387,62,0.004610008179046769
260,2022-04-07,384514,381756,2758,0.007172690721274128
261,2022-04-08,375216,373373,1843,0.004911837448296448
262,2022-04-10,27046,26901,145,0.005361236412038749
263,2022-04-11,476515,473767,2748,0.005766869878178022
264,2022-04-12,355982,353558,2424,0.006809333056165761
265,2022-04-13,14867,14803,64,0.004304836214434654
266,2022-04-14,492333,488941,3392,0.006889645829144095
267,2022-04-15,327540,325739,1801,0.005498565060755938
268,2022-04-17,51138,50894,244,0.004771402870663694
269,2022-04-18,413559,411215,2344,0.005667873265966888
270,2022-04-19,356260,354155,2105,0.0059086060742154604
271,2022-04-20,39442,39259,183,0.004639724151919274
272,2022-04-21,456565,454112,2453,0.0053727289652075825
273,2022-04-22,340829,338840,1989,0.005835771017137626
274,2022-04-24,2053,2032,21,0.010228933268387726
275,2022-04-25,33623,33215,408,0.01213455075394819
276,2022-04-26,138168,136897,1271,0.009198946210410515
277,2022-04-27,69789,69456,333,0.004771525598590036
278,2022-04-28,381587,379330,2257,0.005914771729644878
279,2022-04-29,304061,302305,1756,0.005775156958636589
280,2022-04-30,62734,62371,363,0.005786335958172602
281,2022-05-02,485066,482243,2823,0.005819826580300413
282,2022-05-03,349594,347336,2258,0.006458920919695418
283,2022-05-04,32574,32373,201,0.0061705654816725
284,2022-05-05,460585,457581,3004,0.006522140321547597
285,2022-05-06,335265,333091,2174,0.006484422770047574
286,2022-05-09,56392,55918,474,0.008405447581217194
287,2022-05-10,151540,150394,1146,0.007562359772997228
288,2022-05-12,58290,57642,648,0.011116829644879053
289,2022-05-13,119540,118243,1297,0.010849924711393675
290,2022-05-16,54483,53786,697,0.012792981296918304
291,2022-05-17,147831,146753,1078,0.007292110585736415
292,2022-05-19,54138,53611,527,0.009734382503971333
293,2022-05-20,146067,145057,1010,0.006914635064730569
294,2022-05-23,52188,51586,602,0.011535218824250786
295,2022-05-24,138542,137359,1183,0.00853892682363471
296,2022-05-26,58484,57895,589,0.010071130565624786
297,2022-05-27,111871,110981,890,0.007955591708306889
298,2022-05-30,52078,51687,391,0.007507968816006759
299,2022-05-31,131812,130992,820,0.006220981397748308
300,2022-06-02,54251,53847,404,0.007446867338850896
301,2022-06-03,124091,122835,1256,0.010121604306516992
302,2022-06-06,55724,55076,648,0.011628741655301127
303,2022-06-07,115849,114502,1347,0.011627204378112889
304,2022-06-09,53913,53384,529,0.0098121046871812
305,2022-06-10,133399,132084,1315,0.009857645109783432
306,2022-06-13,51624,51129,495,0.009588563458856347
307,2022-06-14,123064,121640,1424,0.011571214977572646
308,2022-06-16,52476,51947,529,0.010080798841375105
309,2022-06-17,128322,126912,1410,0.010987983354374153
310,2022-06-20,55892,55333,559,0.01000143133185429
311,2022-06-21,124080,122462,1618,0.013039974210186977
312,2022-06-23,53053,52496,557,0.010498935027236913
313,2022-06-24,124243,122607,1636,0.013167743856796761
314,2022-06-27,54189,53543,646,0.011921238627765783
315,2022-06-28,106749,104329,2420,0.022670001592520774
316,2022-06-30,56621,55654,967,0.01707846911923138
317,2022-07-01,69117,68474,643,0.009303065815935298
318,2022-07-04,55147,54553,594,0.010771211489292255
319,2022-07-05,114385,113127,1258,0.010997945534816629
320,2022-07-07,80547,79402,1145,0.014215302866649286
321,2022-07-08,90183,89238,945,0.010478693323575396
322,2022-07-12,118804,117215,1589,0.013374970539712467
323,2022-07-14,52494,52061,433,0.008248561740389378
324,2022-07-15,103786,102460,1326,0.012776289672980942
325,2022-07-18,73915,73324,591,0.007995670702834337
326,2022-07-19,91169,90276,893,0.009794996106132567
327,2022-07-21,76374,75694,680,0.008903553565349465
328,2022-07-22,100258,99177,1081,0.010782181970516069
329,2022-07-25,72523,71900,623,0.008590378224839016
330,2022-07-26,84019,83163,856,0.01018817172306264
331,2022-07-28,70548,69712,836,0.011850087883426886
332,2022-07-29,100933,100068,865,0.008570041512686633
333,2022-08-01,73139,72217,922,0.01260613352657269
334,2022-08-02,90452,89493,959,0.010602308406668731
335,2022-08-04,73183,72571,612,0.008362597871090281
336,2022-08-05,99955,99002,953,0.009534290430693813
337,2022-08-08,73366,72795,571,0.0077828967096475205
338,2022-08-09,90052,89163,889,0.009872073912850353
339,2022-08-11,74891,74151,740,0.00988102709270807
340,2022-08-12,93198,92130,1068,0.011459473379257066
341,2022-08-15,73723,73086,637,0.008640451419502733
342,2022-08-16,95654,94400,1254,0.013109749722959835
343,2022-08-18,74043,73547,496,0.006698810150858285
344,2022-08-19,88606,87580,1026,0.011579351285465996
345,2022-08-22,67398,66941,457,0.006780616635508472
346,2022-08-23,100057,98703,1354,0.013532286596639916
347,2022-08-25,51124,50837,287,0.00561380173695329
348,2022-08-26,110325,109237,1088,0.009861772037162929
349,2022-08-29,76089,75557,532,0.00699181221990038
350,2022-08-30,90815,89827,988,0.01087926003413533
351,2022-09-01,76258,75735,523,0.006858296834430486
352,2022-09-02,91864,90907,957,0.010417573804754854
353,2022-09-05,75537,74982,555,0.007347392668493586
354,2022-09-06,93763,92871,892,0.009513347482482429
355,2022-09-08,55448,55085,363,0.006546674361563988
356,2022-09-09,114338,113246,1092,0.009550630586506674
357,2022-09-12,72912,72377,535,0.007337612464340575
358,2022-09-13,89142,88407,735,0.008245271589149896
359,2022-09-15,70635,69341,1294,0.018319529978056203
360,2022-09-16,75038,71404,3634,0.0484287960766545
361,2022-09-19,54492,54159,333,0.006110988768993614
362,2022-09-20,106028,104854,1174,0.011072546874410533
363,2022-09-22,66582,66165,417,0.006262953951518428
364,2022-09-23,105563,104476,1087,0.010297168515483644
365,2022-09-26,16957,16812,145,0.00855104086807808
366,2022-09-27,143816,142420,1396,0.009706847638649384
367,2022-09-29,75763,74754,1009,0.013317846442194739
368,2022-09-30,96528,95471,1057,0.010950190618266202
369,2022-10-03,69167,68626,541,0.007821649052293723
370,2022-10-04,96919,95901,1018,0.010503616421960606
371,2022-10-06,70859,70452,407,0.005743801069730027
372,2022-10-07,96173,95221,952,0.009898828153431837
373,2022-10-10,68474,68071,403,0.005885445570581535
374,2022-10-11,102971,102053,918,0.008915131444775714
375,2022-10-13,50181,49912,269,0.005360594647376497
376,2022-10-14,105269,103949,1320,0.01253930406862419
377,2022-10-19,3601,3591,10,0.0027770063871146904
378,2022-10-20,43888,43663,225,0.005126686110098432
379,2022-10-21,101915,100591,1324,0.012991218172006084
380,2022-10-23,4662,4652,10,0.002145002145002145
381,2022-10-24,46587,46320,267,0.005731212570030266
382,2022-10-25,99326,98123,1203,0.012111632402392124
383,2022-10-27,54906,54604,302,0.005500309620077952
384,2022-10-28,89023,88231,792,0.008896577289015198
385,2022-10-30,5205,5184,21,0.004034582132564841
386,2022-10-31,49468,49188,280,0.005660224791784588
387,2022-11-01,97343,96312,1031,0.010591413866431074
388,2022-11-03,61553,61263,290,0.004711386934836644
389,2022-11-04,80876,80054,822,0.010163707403926999
390,2022-11-06,5987,5982,5,0.0008351428094204109
391,2022-11-07,46075,45907,168,0.0036462289744981008
392,2022-11-08,85920,85140,780,0.009078212290502794
393,2022-11-09,3392,3392,0,0.0
394,2022-11-10,39659,39517,142,0.003580523966817116
395,2022-11-11,97079,96100,979,0.010084570298416754
396,2022-11-13,4414,4413,1,0.00022655188038060717
397,2022-11-14,53140,52931,209,0.003933007150922092
398,2022-11-15,78733,77931,802,0.010186325937027675
399,2022-11-16,3136,3135,1,0.00031887755102040814
400,2022-11-17,41586,41469,117,0.0028134468330688212
401,2022-11-18,93067,92143,924,0.00992833120225214
402,2022-11-20,4104,4094,10,0.0024366471734892786
403,2022-11-21,46098,45921,177,0.003839645971625667
404,2022-11-22,89533,88583,950,0.01061061284665989
405,2022-11-23,2626,2626,0,0.0
406,2022-11-24,39451,39356,95,0.0024080504930166537
407,2022-11-25,95950,95088,862,0.008983845752996352
408,2022-11-27,1176,1176,0,0.0
409,2022-11-28,37861,37771,90,0.002377116293811574
410,2022-11-29,88910,87994,916,0.010302553143628388
411,2022-11-30,686,686,0,0.0
412,2022-12-01,35516,35338,178,0.005011825656042347
413,2022-12-02,89345,88268,1077,0.012054395881134926
414,2022-12-04,1503,1492,11,0.007318695941450432
415,2022-12-05,39583,39272,311,0.00785690826870121
416,2022-12-06,84780,83800,980,0.01155933003066761
417,2022-12-07,1852,1844,8,0.004319654427645789
418,2022-12-08,40016,39767,249,0.0062225109956017596
419,2022-12-09,87142,86023,1119,0.012841109912556516
420,2022-12-11,1735,1724,11,0.006340057636887608
421,2022-12-12,39848,39398,450,0.011292913069664725
422,2022-12-13,87820,86749,1071,0.012195399681166022
423,2022-12-14,1872,1872,0,0.0
424,2022-12-15,41839,41745,94,0.0022467076172948686
425,2022-12-16,87654,87007,647,0.007381294635726835
426,2022-12-19,43635,43494,141,0.003231350979718116
427,2022-12-20,90068,89001,1067,0.011846604787493893
428,2022-12-21,1872,1872,0,0.0
429,2022-12-22,40525,40332,193,0.004762492288710673
430,2022-12-23,90894,89841,1053,0.011584923097234141
431,2022-12-25,1744,1744,0,0.0
432,2022-12-26,39977,39861,116,0.0029016684593641344
433,2022-12-27,85937,85163,774,0.009006597856569347
434,2022-12-29,32758,32710,48,0.0014652909213016669
435,2022-12-30,100640,98870,1770,0.017587440381558028
436,2023-01-01,1432,1431,1,0.0006983240223463687
437,2023-01-02,21606,21441,165,0.007636767564565399
438,2023-01-03,91205,89347,1858,0.020371690148566417
439,2023-01-04,1317,1316,1,0.0007593014426727411
440,2023-01-05,21893,21731,162,0.007399625451057415
441,2023-01-06,94124,92161,1963,0.020855467255960224
442,2023-01-08,4254,4210,44,0.010343206393982134
443,2023-01-09,50491,49936,555,0.010992057990532966
444,2023-01-10,80871,79593,1278,0.01580294543161331
445,2023-01-11,1670,1661,9,0.005389221556886228
446,2023-01-12,48056,47763,293,0.006097053437656068
447,2023-01-13,78821,77410,1411,0.017901320714022912
448,2023-01-16,41020,40469,551,0.013432471964895174
449,2023-01-17,96264,95087,1177,0.01222679298595529
450,2023-01-18,1192,1180,12,0.010067114093959731
451,2023-01-19,37025,36491,534,0.014422687373396354
452,2023-01-20,94090,92991,1099,0.011680306089913913
453,2023-01-22,933,925,8,0.00857449088960343
454,2023-01-23,37784,37538,246,0.006510692356553038
455,2023-01-24,95812,94458,1354,0.014131841522982507
456,2023-01-25,966,962,4,0.004140786749482402
457,2023-01-26,40519,40237,282,0.006959697919494558
458,2023-01-27,90784,89092,1692,0.018637645400070495
459,2023-01-30,41742,41350,392,0.009391021033970581
460,2023-01-31,88475,87134,1341,0.015156823961571066
461,2023-02-01,1806,1791,15,0.008305647840531562
462,2023-02-02,35288,34809,479,0.013574019496712764
463,2023-02-03,100194,98675,1519,0.015160588458390722
464,2023-02-05,757,753,4,0.005284015852047556
465,2023-02-06,39181,38947,234,0.005972282483856972
466,2023-02-07,100356,98402,1954,0.01947068436366535
467,2023-02-08,1197,1190,7,0.005847953216374269
468,2023-02-09,35150,34924,226,0.006429587482219061
469,2023-02-10,94719,92863,1856,0.019594801465387092
470,2023-02-13,38678,38315,363,0.009385180205801747
471,2023-02-14,98050,95381,2669,0.02722080571137175
472,2023-02-15,2553,2537,16,0.00626713670191931
473,2023-02-16,35230,34524,706,0.020039738858927052
474,2023-02-17,100085,98095,1990,0.01988309936553929
475,2023-02-20,36269,36020,249,0.006865367117924398
476,2023-02-21,105785,104111,1674,0.01582454979439429
477,2023-02-22,1462,1450,12,0.008207934336525308
478,2023-02-23,35574,35332,242,0.006802721088435374
479,2023-02-24,106520,104856,1664,0.015621479534359745
480,2023-02-26,1976,1964,12,0.006072874493927126
481,2023-02-27,31625,31369,256,0.00809486166007905
482,2023-02-28,106217,104487,1730,0.016287411619608914
483,2023-03-01,1988,1975,13,0.006539235412474849
484,2023-03-02,28558,28371,187,0.006548077596470341
485,2023-03-03,93823,92782,1041,0.011095360412691983
486,2023-03-04,13413,13181,232,0.017296652501304705
487,2023-03-05,1726,1715,11,0.006373117033603708
488,2023-03-06,29470,29291,179,0.006073973532405836
489,2023-03-07,104191,102929,1262,0.012112370550239464
490,2023-03-09,35532,35144,388,0.010919734323989643
491,2023-03-10,104561,102615,1946,0.01861114564703857
492,2023-03-13,34479,34110,369,0.010702166536152441
493,2023-03-14,102033,100123,1910,0.018719433908637402
494,2023-03-15,327,327,0,0.0
495,2023-03-16,5742,5742,0,0.0
496,2023-03-17,109874,107687,2187,0.01990461801700129
497,2023-03-19,2094,2075,19,0.009073543457497613
498,2023-03-20,28251,28010,241,0.008530671480655552
499,2023-03-21,109712,107546,2166,0.019742598804141753
500,2023-03-22,2081,2059,22,0.010571840461316675
501,2023-03-23,28041,27774,267,0.009521771691451802
502,2023-03-24,108396,106149,2247,0.020729547215764418
503,2023-03-26,1619,1607,12,0.0074119827053736875
504,2023-03-27,34189,33831,358,0.010471204188481676
505,2023-03-28,103040,100711,2329,0.022602872670807454
506,2023-03-29,1624,1614,10,0.006157635467980296
507,2023-03-30,34930,34594,336,0.009619238476953907
508,2023-03-31,97105,94957,2148,0.02212038515009526
